Barcode	cellType
AAACCCAAGAGGTCAC-1	NK cells
AAACCCAAGGCTCTCG-1	Macrophages
AAACCCACACTAGTAC-1	Epithelial cells
AAACCCAGTACGGGAT-1	Epithelial cells
AAACCCATCTATTCGT-1	T cells
AAACGAAAGCACAAAT-1	T cells
AAACGAAAGGATATAC-1	Epithelial cells
AAACGAACACGAGGAT-1	Monocytes
AAACGAATCGACGCGT-1	Macrophages
AAACGAATCGGCGATC-1	DC
AAACGCTAGATTGGGC-1	T cells
AAACGCTCAAATCAAG-1	T cells
AAACGCTTCAACCCGG-1	T cells
AAACGCTTCTAGATCG-1	T cells
AAAGAACAGATGATTG-1	T cells
AAAGAACAGGACGCTA-1	T cells
AAAGAACAGTATGAGT-1	Epithelial cells
AAAGAACCACCCTATC-1	T cells
AAAGAACGTAAGGCTG-1	T cells
AAAGAACGTCCGTACG-1	T cells
AAAGAACGTTACAGCT-1	T cells
AAAGAACGTTCAGTAC-1	NK cells
AAAGAACTCACCCATC-1	T cells
AAAGGATAGATGACAT-1	T cells
AAAGGATAGTACAGCG-1	Epithelial cells
AAAGGATGTACGACAG-1	T cells
AAAGGATGTGTCACAT-1	T cells
AAAGGATTCGATTTCT-1	T cells
AAAGGATTCTTGTTAC-1	Epithelial cells
AAAGGGCAGTTTCAGC-1	Epithelial cells
AAAGGGCCAACTGTGT-1	Macrophages
AAAGGGCCAATACCTG-1	Macrophages
AAAGGGCCAGCATCTA-1	DC
AAAGGGCCAGCCTTCT-1	T cells
AAAGGGCGTATGAAGT-1	T cells
AAAGGGCTCGTGCATA-1	T cells
AAAGGGCTCTTGCAGA-1	T cells
AAAGGTAAGTCAACAA-1	T cells
AAAGGTAGTCTTACTT-1	B cells
AAAGGTATCCGATGCG-1	T cells
AAAGGTATCGGCTCTT-1	Epithelial cells
AAAGTCCCAAGAGTAT-1	Epithelial cells
AAAGTCCCAATGCAGG-1	T cells
AAAGTCCCACTGTTCC-1	Epithelial cells
AAAGTCCCATGCGTGC-1	Epithelial cells
AAAGTCCCATTACGGT-1	T cells
AAAGTCCGTACAAGCG-1	Macrophages
AAAGTCCGTCCGTACG-1	Epithelial cells
AAAGTCCGTGACATCT-1	DC
AAAGTGAAGAGTCAGC-1	T cells
AAAGTGAGTCAGCTTA-1	Endothelial cells
AAAGTGATCGACCTAA-1	Macrophages
AAATGGACAAAGGCTG-1	T cells
AAATGGACAACCACAT-1	Plasma cells
AAATGGACACCAATTG-1	T cells
AAATGGACACTGAGTT-1	T cells
AAATGGACATGAATCC-1	Macrophages
AAATGGATCCATCTCG-1	T cells
AACAAAGAGAGGGTCT-1	T cells
AACAAAGAGCTTACGT-1	T cells
AACAAAGAGGTACATA-1	B cells
AACAAAGAGTCGGGAT-1	Fibroblasts
AACAAAGGTGGGTCAA-1	T cells
AACAAAGGTTCGGTAT-1	NK cells
AACAAAGGTTGTCATG-1	Epithelial cells
AACAAAGGTTGTTGCA-1	Macrophages
AACAAAGTCCGCAGTG-1	T cells
AACAACCGTACGGATG-1	Fibroblasts
AACAAGAAGCTGAAAT-1	Macrophages
AACAAGATCAATCCGA-1	T cells
AACAAGATCGAGCCTG-1	NK cells
AACAAGATCTCAGTCC-1	T cells
AACACACAGCAAATGT-1	Epithelial cells
AACACACCAGAGTAAT-1	Macrophages
AACACACGTCATACCA-1	T cells
AACACACTCGATTTCT-1	T cells
AACACACTCGGCTTCT-1	T cells
AACACACTCTTCTAAC-1	T cells
AACAGGGAGGATAATC-1	T cells
AACAGGGAGGGTCTTT-1	T cells
AACAGGGGTAGTATAG-1	Monocytes
AACAGGGGTTATAGCC-1	T cells
AACAGGGTCTAGACAC-1	Macrophages
AACAGGGTCTCGCAGG-1	T cells
AACCAACAGATAGTCA-1	T cells
AACCAACAGGGATCAC-1	T cells
AACCAACGTAAGGCCA-1	T cells
AACCAACTCCAGTACA-1	Epithelial cells
AACCAACTCCTAGCCT-1	T cells
AACCAACTCGTCCATC-1	Epithelial cells
AACCACAAGCCTTGAT-1	B cells
AACCACACAAAGGCTG-1	Monocytes
AACCACACACTACGGC-1	Macrophages
AACCACACATGTTCAG-1	Monocytes
AACCACAGTCAAATCC-1	T cells
AACCACAGTCGACTTA-1	DC
AACCACAGTCGTGTTA-1	Epithelial cells
AACCACAGTTACCTTT-1	T cells
AACCACAGTTGGGACA-1	T cells
AACCACATCCGATAGT-1	B cells
AACCATGAGCACACAG-1	T cells
AACCATGAGCTACGTT-1	T cells
AACCATGCAATAGGAT-1	T cells
AACCATGGTGGACTAG-1	T cells
AACCATGGTGTTCGAT-1	Epithelial cells
AACCATGTCCACTGAA-1	T cells
AACCATGTCGCTACGG-1	T cells
AACCCAAAGTTCACTG-1	T cells
AACCCAAGTAGTATAG-1	Macrophages
AACCTGACACAAATCC-1	T cells
AACCTGACAGCAGAAC-1	Epithelial cells
AACCTTTAGACTTCAC-1	T cells
AACCTTTCAAGCTGCC-1	Endothelial cells
AACCTTTCAGGTCTCG-1	NK cells
AACCTTTGTAAGTCAA-1	T cells
AACCTTTGTTGACTGT-1	T cells
AACCTTTTCTTGGTGA-1	T cells
AACGAAAAGTATAGAC-1	NK cells
AACGAAAAGTGCGTCC-1	Monocytes
AACGAAACAACTCCAA-1	T cells
AACGAAAGTAGTGGCA-1	Macrophages
AACGAAAGTGAATGTA-1	Macrophages
AACGAAATCACTACTT-1	T cells
AACGAAATCCCTTGTG-1	T cells
AACGAAATCCTGGCTT-1	T cells
AACGGGAAGAGCATTA-1	DC
AACGGGAAGGGTGAAA-1	T cells
AACGGGACATCCCGTT-1	T cells
AACGGGAGTAGGGTAC-1	T cells
AACGGGATCCAGCCTT-1	T cells
AACGGGATCTCTATAC-1	Monocytes
AACGTCAAGCGCTTCG-1	Macrophages
AACGTCAAGGTAGATT-1	Endothelial cells
AACGTCAAGGTCCGAA-1	T cells
AACGTCACACAAATGA-1	T cells
AACGTCACAGATCATC-1	T cells
AACGTCAGTCTTGGTA-1	DC
AACGTCAGTTTACTGG-1	T cells
AACGTCATCGCCTTGT-1	T cells
AACGTCATCTGTCGTC-1	Macrophages
AACTTCTAGCCATTGT-1	T cells
AACTTCTGTTAAGAAC-1	T cells
AACTTCTTCGATACGT-1	T cells
AACTTCTTCTTCGGTC-1	T cells
AAGAACAAGTCATCGT-1	B cells
AAGAACACAAGATCCT-1	Epithelial cells
AAGAACAGTGCATTAC-1	B cells
AAGAACAGTTAAGAAC-1	T cells
AAGACAACAAGTATCC-1	T cells
AAGACAAGTGACCTGC-1	T cells
AAGACAAGTGAGGCAT-1	T cells
AAGACAATCAAACTGC-1	Fibroblasts
AAGACAATCACGGTCG-1	T cells
AAGACAATCCGGTAAT-1	T cells
AAGACAATCGCTAATG-1	Macrophages
AAGACAATCGCTACAA-1	Epithelial cells
AAGACAATCGTGTGGC-1	T cells
AAGACTCGTAACTGCT-1	pDC
AAGACTCTCTTAGCAG-1	pDC
AAGATAGAGATAGTCA-1	Epithelial cells
AAGATAGGTCTCACGG-1	T cells
AAGATAGTCAAGCTTG-1	T cells
AAGATAGTCATCCTGC-1	Epithelial cells
AAGCATCAGCCGTAAG-1	Monocytes
AAGCATCCAACCAGAG-1	T cells
AAGCATCCACAGAAGC-1	Epithelial cells
AAGCATCCATCCTCAC-1	T cells
AAGCATCGTAATGATG-1	Epithelial cells
AAGCATCTCATCTACT-1	T cells
AAGCCATCAAGTCCAT-1	Epithelial cells
AAGCCATGTAACCCGC-1	Epithelial cells
AAGCCATTCGCGTGAC-1	T cells
AAGCGAGAGTAGGGTC-1	NK cells
AAGCGAGCACACTGGC-1	T cells
AAGCGAGCATTCACCC-1	T cells
AAGCGAGGTACTAAGA-1	Macrophages
AAGCGTTCACTGTTCC-1	NK cells
AAGCGTTGTGCTCGTG-1	T cells
AAGCGTTGTTTGTTGG-1	Monocytes
AAGCGTTTCCCGAGAC-1	Monocytes
AAGGAATAGAAATTGC-1	Epithelial cells
AAGGAATAGTGATAGT-1	Epithelial cells
AAGGAATCAAACTAGA-1	T cells
AAGGAATGTACAGTAA-1	Macrophages
AAGGAATGTACGATTC-1	Epithelial cells
AAGGAATGTCTGATCA-1	T cells
AAGGAATTCATACAGC-1	T cells
AAGGAATTCGCTTAAG-1	pDC
AAGGTAACAACTCGTA-1	T cells
AAGGTAACATCGTCCT-1	NK cells
AAGGTAATCTATCGTT-1	T cells
AAGTACCAGCTGCGAA-1	Endothelial cells
AAGTACCGTACGTGAG-1	Monocytes
AAGTACCGTACTGGGA-1	Macrophages
AAGTACCGTCCACGCA-1	Epithelial cells
AAGTACCGTCGCATTA-1	B cells
AAGTACCGTGAGTCAG-1	T cells
AAGTACCTCATTTGCT-1	T cells
AAGTACCTCCTACCGT-1	T cells
AAGTACCTCCTGGGTG-1	T cells
AAGTACCTCTTTGGAG-1	T cells
AAGTCGTAGCCAGAGT-1	Epithelial cells
AAGTCGTGTATCGGTT-1	Macrophages
AAGTCGTGTGCAGTGA-1	T cells
AAGTGAAAGAAATCCA-1	B cells
AAGTGAAAGGAAACGA-1	T cells
AAGTGAACAGCTTTCC-1	B cells
AAGTGAACATGACGTT-1	DC
AAGTGAAGTATGATCC-1	T cells
AAGTGAAGTGCCTATA-1	T cells
AAGTGAATCTCGTGGG-1	T cells
AAGTGAATCTTCCCGA-1	Macrophages
AAGTTCGAGATGGTAT-1	T cells
AAGTTCGAGCGGTATG-1	T cells
AAGTTCGCAGAGGTAC-1	NK cells
AAGTTCGCATAGAAAC-1	DC
AATAGAGAGACGCCCT-1	Macrophages
AATAGAGCACGCGCTA-1	Macrophages
AATAGAGCATCGATAC-1	Fibroblasts
AATAGAGGTATGCGGA-1	T cells
AATAGAGGTCAACACT-1	T cells
AATCACGGTCGCATGC-1	T cells
AATCACGGTGTACGCC-1	Epithelial cells
AATCACGGTTGTGCCG-1	T cells
AATCACGTCAAGTAAG-1	T cells
AATCACGTCCGCAGTG-1	T cells
AATCGACCAGGTCCGT-1	T cells
AATCGACGTGAGCGAT-1	T cells
AATCGTGAGTGGCGAT-1	T cells
AATCGTGCAATAGTCC-1	Macrophages
AATCGTGCACGGTAGA-1	Epithelial cells
AATCGTGGTGTGATGG-1	T cells
AATCGTGGTTGCCAAT-1	T cells
AATCGTGTCGTTGTTT-1	Macrophages
AATGAAGCAATAGGGC-1	B cells
AATGAAGCAATAGTAG-1	T cells
AATGAAGCACACCTAA-1	T cells
AATGAAGGTGCCCAGT-1	T cells
AATGAAGGTTGCACGC-1	NK cells
AATGAAGTCACCGACG-1	Fibroblasts
AATGAAGTCCTCGATC-1	T cells
AATGACCCAGGTATGG-1	T cells
AATGACCCAGTAACCT-1	T cells
AATGACCTCGATTGGT-1	T cells
AATGCCACAAGTACCT-1	Macrophages
AATGCCACATCGCTCT-1	T cells
AATGCCATCATGGCCG-1	T cells
AATGCCATCGAGAGAC-1	Macrophages
AATGGAAAGACTGAGC-1	T cells
AATGGAACAATACGCT-1	T cells
AATGGAACACAAGCCC-1	Epithelial cells
AATGGAACAGAGTTCT-1	NK cells
AATGGAACATGCCGAC-1	T cells
AATGGAAGTACGCGTC-1	T cells
AATGGAATCGATGCAT-1	Epithelial cells
AATGGAATCTCGAGTA-1	Epithelial cells
AATGGCTCAAATAAGC-1	T cells
AATGGCTCAGTCTTCC-1	T cells
AATGGCTCATGGACAG-1	T cells
AATGGCTGTTTGTTCT-1	NK cells
AATTCCTCACAAACGG-1	Epithelial cells
AATTCCTGTATCTCGA-1	Endothelial cells
AATTCCTTCGCCAGTG-1	T cells
AATTTCCAGCCGTCGT-1	Fibroblasts
AATTTCCAGGAAGTGA-1	Macrophages
AATTTCCCAATCTCGA-1	Fibroblasts
AATTTCCCAGGGACTA-1	Macrophages
AATTTCCGTCTGCGCA-1	T cells
AATTTCCTCACCTGGG-1	Fibroblasts
AATTTCCTCGACGACC-1	T cells
AATTTCCTCTTTCCAA-1	T cells
ACAAAGAAGAGCTGAC-1	Epithelial cells
ACAAAGAAGTTGCTGT-1	Epithelial cells
ACAAAGACAGCGCGTT-1	Monocytes
ACAAAGACATCACGGC-1	T cells
ACAAAGAGTGTTACAC-1	T cells
ACAAAGATCCAGTACA-1	Epithelial cells
ACAAAGATCCGAACGC-1	T cells
ACAAAGATCTCATGGA-1	DC
ACAAAGATCTGGGAGA-1	T cells
ACAACCACAGATTTCG-1	Epithelial cells
ACAACCACAGTCAGTT-1	T cells
ACAACCAGTACTGCCG-1	T cells
ACAACCAGTTTGTTGG-1	T cells
ACAACCATCAAGGTGG-1	T cells
ACAACCATCCCATGGG-1	T cells
ACAACCATCGGCCCAA-1	Monocytes
ACAACCATCTTCCGTG-1	T cells
ACAAGCTTCATAGACC-1	T cells
ACAAGCTTCCAGTACA-1	T cells
ACAAGCTTCTGAGAGG-1	T cells
ACACAGTAGCAGCCTC-1	T cells
ACACAGTAGGCCTAGA-1	Monocytes
ACACAGTCACTCTAGA-1	T cells
ACACAGTGTTCTCGCT-1	Macrophages
ACACAGTTCAACCTTT-1	T cells
ACACAGTTCCATCACC-1	Epithelial cells
ACACCAAAGAACTGAT-1	T cells
ACACCAACACATCCCT-1	T cells
ACACCAACAGAAGTTA-1	Monocytes
ACACCAACATCCAACA-1	B cells
ACACCAAGTAGCTTAC-1	T cells
ACACCAAGTATGTCTG-1	Macrophages
ACACCAAGTCTTTATC-1	T cells
ACACCAATCATAGACC-1	Fibroblasts
ACACCAATCGTTGCCT-1	NK cells
ACACGCGCACGGTCTG-1	T cells
ACACGCGCATTGCCGG-1	pDC
ACACTGAAGCTGGTGA-1	T cells
ACACTGAGTGGAGAAA-1	T cells
ACACTGATCAGTCAGT-1	T cells
ACAGAAAAGCTGCGAA-1	T cells
ACAGAAAAGGCCTGCT-1	T cells
ACAGAAACACCGTACG-1	Epithelial cells
ACAGAAACACCTGTCT-1	Epithelial cells
ACAGAAACATCATTTC-1	T cells
ACAGAAAGTACGTAGG-1	Epithelial cells
ACAGAAAGTCGCACGT-1	T cells
ACAGAAATCAGCAGAG-1	Macrophages
ACAGAAATCTCTGACC-1	Macrophages
ACAGCCGAGCAGGCAT-1	T cells
ACAGCCGCACAAATAG-1	pDC
ACAGCCGGTATCGTTG-1	Epithelial cells
ACAGCCGGTGATTGGG-1	Macrophages
ACAGGGAAGACGCCCT-1	T cells
ACAGGGAAGGCTAACG-1	DC
ACAGGGACAGCAGATG-1	Epithelial cells
ACAGGGACAGCGAGTA-1	Epithelial cells
ACAGGGACATATGGCT-1	T cells
ACAGGGAGTCATAAAG-1	T cells
ACAGGGAGTCCGGATC-1	T cells
ACAGGGATCAGTCTTT-1	Epithelial cells
ACAGGGATCCTACTGC-1	T cells
ACAGGGATCGTGCGAC-1	Fibroblasts
ACAGGGATCTCAGGCG-1	Macrophages
ACATCCCAGCTAATGA-1	Epithelial cells
ACATCCCAGGACTAAT-1	Epithelial cells
ACATCCCGTAACATGA-1	T cells
ACATCCCGTGACACGA-1	Epithelial cells
ACATCCCTCTGGGAGA-1	Epithelial cells
ACATCCCTCTTACCGC-1	Epithelial cells
ACATCGAAGAAGGATG-1	Monocytes
ACATCGAAGCTGAAGC-1	T cells
ACATCGACAACGGTAG-1	Epithelial cells
ACATCGAGTAAGATCA-1	Epithelial cells
ACATCGAGTACAGTCT-1	T cells
ACATGCAAGACTGTTC-1	T cells
ACATGCAAGCACACAG-1	Endothelial cells
ACATGCAAGGGTCACA-1	T cells
ACATGCAAGGTGCGAT-1	Macrophages
ACATGCACACAAGCAG-1	T cells
ACATGCACAGTCGAGA-1	pDC
ACATGCATCATCCTAT-1	Macrophages
ACATGCATCGCAGTTA-1	T cells
ACATTTCAGGCTAAAT-1	T cells
ACATTTCCAGCAGTGA-1	T cells
ACATTTCCAGGCCCTA-1	T cells
ACATTTCCAGGCCTGT-1	T cells
ACATTTCCATCCGGTG-1	Fibroblasts
ACATTTCGTGACTAAA-1	DC
ACATTTCGTGTTTCTT-1	T cells
ACATTTCTCATTTCCA-1	T cells
ACATTTCTCCTAGCGG-1	NK cells
ACCAAACAGCACCAGA-1	Epithelial cells
ACCAAACCACCACATA-1	T cells
ACCAAACCACTTTAGG-1	Endothelial cells
ACCAAACGTTCACCGG-1	T cells
ACCAAACTCCTTCGAC-1	NK cells
ACCAAACTCGTTCAGA-1	T cells
ACCAAACTCTGACAGT-1	NK cells
ACCAAACTCTTCGACC-1	T cells
ACCAACAAGAGTGTTA-1	Macrophages
ACCAACAAGCCTCTGG-1	Macrophages
ACCAACACAAAGAGTT-1	T cells
ACCAACACAACGAGGT-1	Epithelial cells
ACCAACACAGGACATG-1	Epithelial cells
ACCAACAGTTCTCCAC-1	NK cells
ACCACAAGTCCTACGG-1	pDC
ACCACAATCAAGTCTG-1	T cells
ACCACAATCATGGTAC-1	T cells
ACCACAATCGATCCCT-1	Monocytes
ACCACAATCGCGCTGA-1	T cells
ACCATTTCACATACTG-1	pDC
ACCATTTCAGCTGTCG-1	T cells
ACCATTTGTTAAAGTG-1	T cells
ACCATTTTCACTCACC-1	T cells
ACCCAAACAGCGTTGC-1	DC
ACCCAAAGTACACTCA-1	Macrophages
ACCCAAATCACCGGGT-1	T cells
ACCCTCAAGTGGTCAG-1	Epithelial cells
ACCCTCACAACACACT-1	Epithelial cells
ACCCTCACATGTGGTT-1	T cells
ACCCTCAGTCTACACA-1	T cells
ACCCTCAGTGTGTTTG-1	Epithelial cells
ACCCTCAGTTCGTAAC-1	T cells
ACCCTCATCGTTGTTT-1	T cells
ACCCTTGCATACTGAC-1	T cells
ACCCTTGGTATCACCA-1	Epithelial cells
ACCCTTGGTCCAGCCA-1	Epithelial cells
ACCCTTGGTGTCGCTG-1	Epithelial cells
ACCGTTCAGCCATGCC-1	T cells
ACCGTTCTCATGCGGC-1	T cells
ACCGTTCTCATTACCT-1	T cells
ACCGTTCTCCAACACA-1	T cells
ACCGTTCTCGTCTACC-1	Macrophages
ACCTACCAGAGTTGAT-1	Monocytes
ACCTACCAGCCGTCGT-1	T cells
ACCTACCAGCTCTGTA-1	DC
ACCTACCGTATCGGTT-1	T cells
ACCTACCGTCTACACA-1	Epithelial cells
ACCTACCTCCATTCGC-1	T cells
ACCTACCTCGAAGTGG-1	T cells
ACCTACCTCGCAGTCG-1	T cells
ACCTGAAAGTTGGAAT-1	Epithelial cells
ACCTGAAGTCGTTCAA-1	pDC
ACCTGAAGTGTATTCG-1	T cells
ACCTGAATCAAGTCTG-1	Monocytes
ACCTGAATCTACGCGG-1	T cells
ACCTGTCAGCTGCCTG-1	T cells
ACCTGTCAGGGTGAGG-1	T cells
ACCTGTCCAGTGGGTA-1	B cells
ACCTGTCTCGCTGCGA-1	Macrophages
ACGATCAAGTCTCCTC-1	T cells
ACGATCAAGTGCCGAA-1	T cells
ACGATCAGTACGACAG-1	T cells
ACGATCAGTTCTTCAT-1	Epithelial cells
ACGATCAGTTGTTGAC-1	Epithelial cells
ACGATCATCATCACTT-1	T cells
ACGATCATCTCAAAGC-1	T cells
ACGATGTCACAGTCCG-1	Monocytes
ACGATGTGTTAGTTCG-1	T cells
ACGATGTTCAGCATTG-1	T cells
ACGATGTTCCATTTGT-1	T cells
ACGCACGAGGAAAGAC-1	T cells
ACGCACGAGGACAGCT-1	Epithelial cells
ACGCACGAGGTGCCAA-1	Monocytes
ACGCACGCAAGTCCAT-1	T cells
ACGCACGGTAGTATAG-1	NK cells
ACGCACGGTGTTCATG-1	T cells
ACGCACGGTTGTGCCG-1	Fibroblasts
ACGCACGTCTCGCAGG-1	Epithelial cells
ACGGAAGAGAGGTTTA-1	NK cells
ACGGAAGCAAGATTGA-1	Endothelial cells
ACGGAAGCATCCGATA-1	T cells
ACGGAAGGTGGGTATG-1	T cells
ACGGAAGTCTGCAGCG-1	Endothelial cells
ACGGGTCAGAACCCGA-1	T cells
ACGGGTCAGATTGAGT-1	T cells
ACGGGTCCAGCGGTCT-1	T cells
ACGGGTCGTTACACTG-1	Macrophages
ACGGTCGAGTGGACGT-1	T cells
ACGGTCGCATGGCTGC-1	T cells
ACGGTCGGTCACTGAT-1	T cells
ACGGTCGTCATGAAAG-1	Epithelial cells
ACGGTTAAGACAACTA-1	T cells
ACGGTTAAGCCAACCC-1	T cells
ACGGTTAAGCGGGTTA-1	Epithelial cells
ACGGTTAAGCGGTAAC-1	Endothelial cells
ACGGTTACACGCGTCA-1	T cells
ACGGTTATCATTTGTC-1	Epithelial cells
ACGGTTATCGTTCTCG-1	T cells
ACGGTTATCTGTAACG-1	Epithelial cells
ACGTAACCACGTATAC-1	B cells
ACGTAACTCGGCTTCT-1	Monocytes
ACGTACAAGCCAGAGT-1	Macrophages
ACGTACAAGGCGTTGA-1	T cells
ACGTACAGTAACCCGC-1	T cells
ACGTACATCATCCTAT-1	T cells
ACGTACATCCCGAGGT-1	T cells
ACGTAGTCAGAAGTGC-1	T cells
ACGTAGTTCAAGCTTG-1	T cells
ACGTAGTTCACTACTT-1	Epithelial cells
ACGTAGTTCACTGGGC-1	T cells
ACGTCCTAGTAGGTTA-1	T cells
ACGTCCTCAGCTACCG-1	Fibroblasts
ACGTCCTGTACATTGC-1	Macrophages
ACGTCCTGTGATACAA-1	DC
ACGTCCTTCGGCTCTT-1	pDC
ACGTTCCCAATATCCG-1	T cells
ACGTTCCCATGGGATG-1	NK cells
ACGTTCCGTGATACAA-1	Epithelial cells
ACGTTCCGTTTGTTCT-1	T cells
ACGTTCCTCAGACCCG-1	T cells
ACGTTCCTCTGTACAG-1	NK cells
ACTACGAAGGACTTCT-1	Epithelial cells
ACTACGACATGGAACG-1	Macrophages
ACTACGAGTCAGACGA-1	Macrophages
ACTACGAGTGACAGCA-1	Epithelial cells
ACTACGATCAGATGCT-1	Epithelial cells
ACTACGATCCGGTAAT-1	T cells
ACTATCTAGGGCGAAG-1	Epithelial cells
ACTATCTCACATATCG-1	Epithelial cells
ACTATCTCACGGAAGT-1	Endothelial cells
ACTATCTCATGACTGT-1	T cells
ACTATCTGTCGGAACA-1	T cells
ACTATCTGTGTATTGC-1	Epithelial cells
ACTATCTGTTAAACCC-1	B cells
ACTATCTGTTTAGACC-1	T cells
ACTATCTTCGAGCCTG-1	pDC
ACTATCTTCGCCAGAC-1	pDC
ACTATCTTCTCGTTTA-1	Epithelial cells
ACTATGGAGCCATTTG-1	T cells
ACTATGGAGGTCACAG-1	Fibroblasts
ACTATGGCACAGTGTT-1	Fibroblasts
ACTATGGGTAACCAGG-1	Epithelial cells
ACTATGGGTTGCATGT-1	T cells
ACTATGGTCAATGTCG-1	T cells
ACTATGGTCGACCATA-1	T cells
ACTATTCAGGATTCCT-1	T cells
ACTATTCAGGCTTAAA-1	Macrophages
ACTATTCCAATCTCGA-1	DC
ACTATTCCACGGATCC-1	Macrophages
ACTATTCGTAGTGATA-1	Macrophages
ACTATTCGTAGTGTGG-1	T cells
ACTATTCGTTAGAGTA-1	NK cells
ACTATTCTCGTCTACC-1	T cells
ACTCCCAAGCGCAATG-1	Monocytes
ACTCCCAAGCGTACAG-1	Monocytes
ACTCCCACAACACGTT-1	Epithelial cells
ACTCCCACAACTTCTT-1	T cells
ACTCCCACAAGCACAG-1	Epithelial cells
ACTCCCACATAACTCG-1	DC
ACTCCCACATCCTCAC-1	T cells
ACTCCCATCACGAACT-1	T cells
ACTCCCATCATTACCT-1	T cells
ACTCTCGGTACGAAAT-1	Epithelial cells
ACTCTCGTCGATCCCT-1	Fibroblasts
ACTGATGAGATTTGCC-1	T cells
ACTGCAAAGTGCGTCC-1	pDC
ACTGCAACACCTCTGT-1	T cells
ACTGCAACACGACCTG-1	Epithelial cells
ACTGCAAGTGTCATGT-1	Epithelial cells
ACTGCAAGTTCTTGTT-1	T cells
ACTGTCCAGTAACCTC-1	T cells
ACTGTCCGTAGTCGTT-1	T cells
ACTGTCCTCCCGAGTG-1	T cells
ACTGTGAAGGCGCTTC-1	DC
ACTGTGACAACACGTT-1	Macrophages
ACTGTGACAACCGCCA-1	T cells
ACTGTGACAATTGTGC-1	Epithelial cells
ACTGTGAGTAGCTAAA-1	pDC
ACTGTGAGTCAGACTT-1	B cells
ACTGTGAGTTCCGCGA-1	T cells
ACTTATCAGTTCATCG-1	T cells
ACTTATCCAAGAGATT-1	NK cells
ACTTATCCACGCTGAC-1	T cells
ACTTATCCAGACGCTC-1	Monocytes
ACTTATCCATCACGGC-1	Epithelial cells
ACTTATCGTCACTCAA-1	Epithelial cells
ACTTATCGTGCCCAGT-1	T cells
ACTTATCGTGCTCCGA-1	DC
ACTTATCGTTGGACCC-1	T cells
ACTTATCTCCAGCACG-1	Macrophages
ACTTATCTCCGCAGTG-1	T cells
ACTTATCTCGATACGT-1	T cells
ACTTATCTCTAGACAC-1	Epithelial cells
ACTTCCGCAAGCTGTT-1	Macrophages
ACTTCCGGTGACCGTC-1	T cells
ACTTCCGGTGTTAGCT-1	T cells
ACTTCCGTCAGCACCG-1	Fibroblasts
ACTTCGCAGAAGGATG-1	T cells
ACTTCGCCAGAACATA-1	Epithelial cells
ACTTCGCTCACTGTCC-1	T cells
ACTTCGCTCCCTTCCC-1	Epithelial cells
ACTTTCAAGTGCGCTC-1	T cells
ACTTTCAAGTTACGAA-1	Macrophages
ACTTTCACACCTATCC-1	DC
ACTTTCACACTGTCGG-1	Epithelial cells
ACTTTCACATAATGCC-1	Endothelial cells
ACTTTCAGTGGCAGAT-1	Epithelial cells
ACTTTCATCCGGGACT-1	T cells
ACTTTCATCGCCAATA-1	Plasma cells
ACTTTCATCTAGTCAG-1	T cells
ACTTTGTCACAACATC-1	T cells
ACTTTGTCACTAGAGG-1	T cells
ACTTTGTTCCTTCACG-1	Epithelial cells
ACTTTGTTCGGTAACT-1	T cells
AGAAATGAGTAGAGTT-1	Epithelial cells
AGAAATGGTCAACCTA-1	DC
AGAAATGGTGTCACAT-1	T cells
AGAAATGTCATATGGC-1	T cells
AGAACAAAGAGAGCAA-1	T cells
AGAACAAAGCGGGTTA-1	T cells
AGAACAACAAGTGGGT-1	T cells
AGAACAACAGAATCGG-1	Epithelial cells
AGAACAACAGTGGGTA-1	Epithelial cells
AGAACAAGTATCGATC-1	Epithelial cells
AGAACAAGTCCGAAAG-1	T cells
AGAACAATCTTACTGT-1	T cells
AGAACCTAGGAGAATG-1	T cells
AGAAGCGAGGGACTGT-1	Macrophages
AGAAGCGCAACATACC-1	Macrophages
AGAAGCGCAATCTCTT-1	T cells
AGAAGCGGTAGGAGGG-1	Fibroblasts
AGAAGCGGTCAAACGG-1	T cells
AGAAGTAAGATTGACA-1	T cells
AGAAGTAAGCAAGTGC-1	Epithelial cells
AGAAGTACAAATGCTC-1	Macrophages
AGAAGTATCTGCATAG-1	T cells
AGACAAAAGCACGTCC-1	Fibroblasts
AGACAAAAGGCCTGCT-1	pDC
AGACAAATCACCTTGC-1	T cells
AGACAAATCCTTATAC-1	Monocytes
AGACAAATCTCAGAAC-1	T cells
AGACACTAGTGGATAT-1	T cells
AGACACTGTACGAGTG-1	Macrophages
AGACACTGTTGTCAGT-1	T cells
AGACACTTCGCCCAGA-1	Epithelial cells
AGACACTTCGTGACTA-1	NK cells
AGACACTTCTACTGCC-1	Epithelial cells
AGACAGGAGAGTCAAT-1	T cells
AGACAGGAGTGCACAG-1	Endothelial cells
AGACAGGGTACGCGTC-1	T cells
AGACAGGTCAACCTTT-1	T cells
AGACCATAGTAGCATA-1	T cells
AGACCATCAGGTCTCG-1	NK cells
AGACCATTCCTGCCAT-1	T cells
AGACCCGCAAACCACT-1	T cells
AGACCCGGTGCGCTCA-1	T cells
AGACCCGTCCCAGGAC-1	T cells
AGACCCGTCGACGCGT-1	T cells
AGACTCAAGAAGCGCT-1	Macrophages
AGACTCAAGACTTCGT-1	T cells
AGACTCAAGTTTCTTC-1	T cells
AGACTCACATCCAATG-1	Macrophages
AGACTCAGTTAAAGTG-1	T cells
AGACTCATCTCCTGAC-1	T cells
AGAGAATTCAAGCCGC-1	T cells
AGAGAATTCCGACGGT-1	B cells
AGAGAATTCTTGGTGA-1	Macrophages
AGAGAGCAGAACCGCA-1	Fibroblasts
AGAGAGCAGTGGTGGT-1	Epithelial cells
AGAGAGCAGTTCCAGT-1	T cells
AGAGAGCCAGCAGACA-1	T cells
AGAGAGCGTTCGATTG-1	T cells
AGAGAGCTCCCTTGGT-1	T cells
AGAGCAGAGCATCTTG-1	Epithelial cells
AGAGCAGAGCTGGTGA-1	T cells
AGAGCAGCACTGCTTC-1	DC
AGAGCAGGTCTGTAGT-1	Fibroblasts
AGAGCCCAGCAGTACG-1	T cells
AGAGCCCCAAATTGGA-1	T cells
AGAGCCCCAGATCCAT-1	Epithelial cells
AGAGCCCCAGCGGATA-1	Macrophages
AGAGCCCCATGGCGCT-1	T cells
AGAGCCCGTCTAACTG-1	B cells
AGAGCCCGTTGAAGTA-1	DC
AGATAGAAGCTCCCTT-1	B cells
AGATAGAAGGGCCAAT-1	T cells
AGATAGAAGTATGGCG-1	Epithelial cells
AGATAGACACCCTATC-1	pDC
AGATAGACACTACAGT-1	Macrophages
AGATAGATCCACGTGG-1	T cells
AGATCCAAGTCTGCAT-1	T cells
AGATCCAGTTAAAGTG-1	T cells
AGATCCAGTTCCAGGC-1	B cells
AGATCCATCATGACAC-1	T cells
AGATCCATCCGTGTAA-1	T cells
AGATCCATCTTGTTAC-1	Epithelial cells
AGATCGTGTACTGAGG-1	T cells
AGATCGTTCAGACCGC-1	T cells
AGATCGTTCTGTGCGG-1	Macrophages
AGATGAAAGCGAAACC-1	B cells
AGATGAAAGCGGACAT-1	Monocytes
AGATGAAAGGATACGC-1	Macrophages
AGATGAACACAATGAA-1	T cells
AGATGAACATTGACCA-1	NK cells
AGATGAACATTGCTGA-1	NK cells
AGATGAAGTTCTCTAT-1	Fibroblasts
AGATGAATCTGGTGCG-1	Epithelial cells
AGATGCTGTAAGAACT-1	T cells
AGATGCTTCGACCCAG-1	T cells
AGATGCTTCGGTCGAC-1	T cells
AGATGCTTCGTGGCGT-1	Monocytes
AGATGCTTCTCATTAC-1	T cells
AGCATCACAACACACT-1	T cells
AGCATCACAACCTATG-1	T cells
AGCATCACAAGAGGCT-1	Endothelial cells
AGCATCACACTGTCGG-1	Macrophages
AGCATCACAGACCTGC-1	T cells
AGCATCACATACCAGT-1	T cells
AGCATCATCACTTGTT-1	T cells
AGCCAATAGCCGTTAT-1	Epithelial cells
AGCCAATCAACTGCTA-1	B cells
AGCCAATCAAGACTGG-1	T cells
AGCCAATCAGAGAATT-1	Epithelial cells
AGCCACGAGAGTTGAT-1	T cells
AGCCACGCAAATGGCG-1	Epithelial cells
AGCCACGGTCGAAGCA-1	NK cells
AGCCACGGTTAAACCC-1	B cells
AGCCACGTCAGCGTCG-1	T cells
AGCCACGTCGTTCTAT-1	Epithelial cells
AGCCAGCAGAGTATAC-1	Epithelial cells
AGCCAGCAGCTCGACC-1	T cells
AGCCAGCAGTAGTCAA-1	Macrophages
AGCCAGCCACCGTGGT-1	Macrophages
AGCCAGCCACGCAGTC-1	T cells
AGCCAGCGTCCAGGTC-1	NK cells
AGCCAGCTCTCCTACG-1	T cells
AGCGATTAGCACCAGA-1	T cells
AGCGATTAGGCGAACT-1	T cells
AGCGATTAGGCGCTTC-1	T cells
AGCGATTCAGACAATA-1	T cells
AGCGATTTCCACACAA-1	T cells
AGCGCCAAGTTTGTCG-1	T cells
AGCGCCACAACTGAAA-1	T cells
AGCGCCACAGTATTCG-1	T cells
AGCGCCACAGTGGGTA-1	Epithelial cells
AGCGCCAGTACGCTAT-1	T cells
AGCGCCAGTGGATACG-1	B cells
AGCGCCATCTCGCCTA-1	Epithelial cells
AGCGCCATCTGGCCTT-1	Epithelial cells
AGCGCTGAGAGCAAGA-1	T cells
AGCGCTGAGCAGTAAT-1	T cells
AGCGCTGCAGTCGCTG-1	DC
AGCGCTGTCTTTCAGT-1	Epithelial cells
AGCGTATGTAGACTGG-1	DC
AGCGTATGTAGGCTCC-1	Monocytes
AGCGTCGAGCGGATCA-1	Epithelial cells
AGCGTCGAGGTCGACA-1	Epithelial cells
AGCGTCGCATGAGGGT-1	Epithelial cells
AGCGTCGTCCCGTGAG-1	Fibroblasts
AGCTACACACAAAGCG-1	Epithelial cells
AGCTACACAGGCTACC-1	DC
AGCTACAGTAGTGATA-1	Epithelial cells
AGCTACAGTCGAAACG-1	Monocytes
AGCTACAGTCGCTGCA-1	T cells
AGCTACAGTTGCGAAG-1	T cells
AGCTACATCCGTGGCA-1	T cells
AGCTACATCTCGCCTA-1	NK cells
AGCTCAACAAACTAAG-1	T cells
AGCTCAACAAGCAATA-1	T cells
AGCTCAACATCTCATT-1	Epithelial cells
AGCTCAAGTCTAGATC-1	Macrophages
AGCTCAATCGGACTGC-1	T cells
AGCTTCCAGACCATAA-1	Macrophages
AGCTTCCAGCAGCACA-1	Epithelial cells
AGCTTCCAGTAACCTC-1	T cells
AGCTTCCCAAGCGCTC-1	Epithelial cells
AGCTTCCCACATTACG-1	pDC
AGCTTCCCACTCTAGA-1	Endothelial cells
AGGAAATAGAACTCCT-1	Macrophages
AGGAAATAGAGGGTAA-1	B cells
AGGAAATAGTTCTCTT-1	Epithelial cells
AGGAAATCATAACCCA-1	Epithelial cells
AGGAAATTCGGCACTG-1	T cells
AGGAATAAGGCTCTCG-1	B cells
AGGAATAAGGTCACCC-1	NK cells
AGGAATACAGAGAAAG-1	T cells
AGGACGAAGAGAGCGG-1	T cells
AGGACGAAGAGGCTGT-1	NK cells
AGGACGAAGATGACAT-1	T cells
AGGACGAAGCGGTAAC-1	Epithelial cells
AGGACGAAGGGCTAAC-1	T cells
AGGACGACAACGATTC-1	Epithelial cells
AGGACGACATTGTAGC-1	Epithelial cells
AGGACGAGTGGTACAG-1	T cells
AGGACGAGTGTGGTCC-1	Epithelial cells
AGGACTTAGATCCAAA-1	T cells
AGGACTTCAATACCTG-1	T cells
AGGACTTCACAATGAA-1	T cells
AGGACTTCAGGAATCG-1	Macrophages
AGGACTTTCATGGTAC-1	T cells
AGGACTTTCTATTTCG-1	Epithelial cells
AGGAGGTAGCACCCAC-1	Epithelial cells
AGGAGGTAGCGTCAAG-1	T cells
AGGAGGTCAGAGGCTA-1	Epithelial cells
AGGAGGTTCGTCCTTG-1	B cells
AGGAGGTTCTTGAGCA-1	Epithelial cells
AGGATAAAGCTCCACG-1	NK cells
AGGATAAAGGCTCAAG-1	T cells
AGGATAAAGTCTTCGA-1	NK cells
AGGATAATCCGACGGT-1	Epithelial cells
AGGATAATCTCGTCAC-1	T cells
AGGATCTAGGCTAACG-1	T cells
AGGATCTCAGCACAGA-1	Epithelial cells
AGGATCTCATTAGGAA-1	T cells
AGGATCTTCGTAACCA-1	Endothelial cells
AGGCATTAGGACTGGT-1	Epithelial cells
AGGCATTAGTTGGCTT-1	B cells
AGGCATTCAAAGCAAT-1	DC
AGGCATTCAACGATCT-1	Epithelial cells
AGGCATTGTTTGGGTT-1	T cells
AGGCATTTCCAAATGC-1	Macrophages
AGGCATTTCCATAAGC-1	Plasma cells
AGGCATTTCTCCGATC-1	T cells
AGGCCACAGCACTAGG-1	Epithelial cells
AGGCCACAGGGTGAAA-1	T cells
AGGCCACAGTTGCATC-1	T cells
AGGCCACAGTTTCGGT-1	Macrophages
AGGCCACCAATCCAGT-1	Macrophages
AGGCCACGTCGTTGCG-1	Epithelial cells
AGGCTGCAGTCGGCAA-1	Macrophages
AGGCTGCAGTGCAGGT-1	T cells
AGGCTGCCACGACCTG-1	T cells
AGGCTGCGTCGCACGT-1	T cells
AGGCTGCGTGTGTACT-1	Monocytes
AGGCTGCTCAAACGAA-1	Endothelial cells
AGGCTGCTCAAGCCTA-1	T cells
AGGGAGTAGCACCCAC-1	T cells
AGGGAGTCAAGAAACT-1	T cells
AGGGAGTCAGTGCCTG-1	Epithelial cells
AGGGAGTGTATGGAAT-1	T cells
AGGGAGTTCAAAGAAC-1	Epithelial cells
AGGGAGTTCAAAGACA-1	pDC
AGGGAGTTCACCGACG-1	T cells
AGGGCCTAGTATGATG-1	pDC
AGGGCCTTCCCTCTTT-1	T cells
AGGGCCTTCTTCCGTG-1	NK cells
AGGGCTCAGGAAACGA-1	T cells
AGGGCTCAGTAATTGG-1	Monocytes
AGGGCTCCAGGTTCGC-1	T cells
AGGGCTCCAGTCCGTG-1	T cells
AGGGCTCGTGTCGCTG-1	Epithelial cells
AGGGCTCGTTCGTTCC-1	T cells
AGGGCTCTCGAGTTGT-1	Epithelial cells
AGGGTCCTCAGGGATG-1	T cells
AGGGTCCTCATTTACC-1	DC
AGGGTCCTCGCATTAG-1	T cells
AGGGTGAAGACCTCCG-1	B cells
AGGGTGAAGCGTCAAG-1	Epithelial cells
AGGGTGACATCGATCA-1	Macrophages
AGGGTGAGTGCCTACG-1	T cells
AGGGTTTAGGTCTGGA-1	Macrophages
AGGGTTTGTCGCCTAG-1	DC
AGGGTTTTCAGCTTCC-1	T cells
AGGGTTTTCATAGCAC-1	T cells
AGGGTTTTCTGGTCAA-1	T cells
AGGTAGGAGCCTCTCT-1	Macrophages
AGGTAGGCAATTCTCT-1	Epithelial cells
AGGTAGGCACGAAGAC-1	T cells
AGGTAGGCAGGAGACT-1	NK cells
AGGTAGGCATAACAGA-1	B cells
AGGTAGGGTAACAAGT-1	Epithelial cells
AGGTAGGTCCTTATCA-1	T cells
AGGTAGGTCGGACGTC-1	Macrophages
AGGTCATAGATAGTCA-1	Macrophages
AGGTCATAGCAAATGT-1	T cells
AGGTCATAGCAACCAG-1	T cells
AGGTCATAGCTCTTCC-1	T cells
AGGTCATGTCAGTCTA-1	T cells
AGGTCATGTGCCGTTG-1	T cells
AGGTCATGTTATAGAG-1	T cells
AGGTCTACACCCATAA-1	T cells
AGGTCTACACTTCATT-1	T cells
AGGTCTACATATCGGT-1	Epithelial cells
AGGTCTAGTCGCAGTC-1	T cells
AGGTCTATCACCCATC-1	T cells
AGGTGTTAGAGGTCGT-1	T cells
AGGTGTTAGTAGGCCA-1	T cells
AGGTGTTCAAGTTGGG-1	Monocytes
AGGTGTTGTGAAGCTG-1	Epithelial cells
AGGTGTTGTGCATGAG-1	T cells
AGGTGTTTCACAATGC-1	Epithelial cells
AGGTGTTTCGACCACG-1	Epithelial cells
AGGTTACAGAAATTCG-1	T cells
AGGTTACAGGCTTAGG-1	T cells
AGGTTACCACGGTGAA-1	T cells
AGGTTACTCATTGAGC-1	T cells
AGGTTGTAGGAACTCG-1	Epithelial cells
AGGTTGTAGGGCAATC-1	Fibroblasts
AGGTTGTAGGGCCCTT-1	T cells
AGGTTGTAGTGCAACG-1	Epithelial cells
AGGTTGTTCAACTGGT-1	T cells
AGGTTGTTCATCCTGC-1	Epithelial cells
AGGTTGTTCTCTCAAT-1	T cells
AGTAACCAGAAGGGAT-1	Epithelial cells
AGTAACCAGCCGGAAT-1	T cells
AGTAACCGTCCGGACT-1	T cells
AGTAACCTCCGGTAAT-1	T cells
AGTAACCTCTCGGTCT-1	NK cells
AGTAACCTCTTTCTAG-1	B cells
AGTACCAAGATCCCAT-1	T cells
AGTACCAAGGGAGTTC-1	T cells
AGTACCACAGTATACC-1	T cells
AGTACCATCCCAAGCG-1	T cells
AGTACTGAGTTGCGAG-1	T cells
AGTAGCTCACAACCGC-1	T cells
AGTAGCTCACCCAATA-1	Macrophages
AGTAGCTGTGCGAACA-1	T cells
AGTAGCTTCACAAGGG-1	NK cells
AGTAGTCCAGAGGGTT-1	Endothelial cells
AGTAGTCGTGTATACC-1	DC
AGTAGTCTCCTACGAA-1	T cells
AGTAGTCTCGCGTGCA-1	T cells
AGTCAACAGCTCCATA-1	T cells
AGTCAACGTTTGAACC-1	DC
AGTCAACTCAAGAGGC-1	T cells
AGTCAACTCACTGTTT-1	Epithelial cells
AGTCACAGTCTGTGCG-1	T cells
AGTCATGAGCTAAATG-1	NK cells
AGTCATGAGGTTCAGG-1	T cells
AGTCATGCAGCTGCCA-1	B cells
AGTCATGCAGGCCCTA-1	Epithelial cells
AGTCTCCAGGTTGGTG-1	Fibroblasts
AGTCTCCAGTAATCCC-1	T cells
AGTCTCCAGTCGTCTA-1	DC
AGTCTCCCAGGGATAC-1	T cells
AGTCTCCTCAACACGT-1	NK cells
AGTCTCCTCAAGCTGT-1	T cells
AGTGACTAGATGCTGG-1	pDC
AGTGACTCACGGAAGT-1	Epithelial cells
AGTGACTCAGGTCCCA-1	Epithelial cells
AGTGACTCATTAAAGG-1	Macrophages
AGTGACTGTAAGATTG-1	T cells
AGTGACTGTACAAGCG-1	Macrophages
AGTGACTTCACTAGCA-1	NK cells
AGTGACTTCATAGAGA-1	T cells
AGTGACTTCCAATGCA-1	Macrophages
AGTGACTTCCACGGGT-1	T cells
AGTGACTTCTAGAACC-1	Epithelial cells
AGTGACTTCTGTCCGT-1	Monocytes
AGTGATCAGATTTGCC-1	T cells
AGTGATCAGTAAGCAT-1	T cells
AGTGATCCATTGTGCA-1	Epithelial cells
AGTGATCTCCATTTCA-1	B cells
AGTGCCGAGATTCGCT-1	T cells
AGTGCCGAGCTGTTAC-1	T cells
AGTGCCGAGTCAACAA-1	B cells
AGTGCCGAGTGGCAGT-1	DC
AGTGCCGTCAGTAGGG-1	B cells
AGTGTTGAGAGTCCGA-1	T cells
AGTGTTGAGCGATTCT-1	NK cells
AGTGTTGCAACAGCCC-1	T cells
AGTGTTGCAGAAGTTA-1	DC
AGTGTTGCAGCACCCA-1	NK cells
AGTGTTGGTCGTGGTC-1	T cells
AGTGTTGGTTGTGGAG-1	T cells
AGTGTTGTCGTAGAGG-1	T cells
AGTGTTGTCGTTATCT-1	Epithelial cells
AGTTAGCAGAAACACT-1	pDC
AGTTAGCAGCGCCTCA-1	T cells
AGTTAGCCAGGCATTT-1	T cells
AGTTAGCGTTAGAGTA-1	T cells
AGTTAGCTCGTCGATA-1	Macrophages
AGTTCCCAGCATCAGG-1	T cells
AGTTCCCAGGCTAACG-1	Epithelial cells
AGTTCCCGTTGGTAGG-1	Macrophages
AGTTCCCTCGTAGTGT-1	B cells
AGTTCCCTCGTCCATC-1	T cells
AGTTCGAAGCCGGAAT-1	T cells
AGTTCGAAGGAGAATG-1	T cells
AGTTCGACATTGACTG-1	DC
AGTTCGAGTCCTTTGC-1	Epithelial cells
AGTTCGATCAAGAAAC-1	T cells
AGTTCGATCCTTATAC-1	Macrophages
ATACCGAAGCCACAAG-1	B cells
ATACCGAAGCCAGACA-1	T cells
ATACCGACAAGTGTCT-1	Monocytes
ATACCGACATCATTTC-1	Epithelial cells
ATACCGATCCTCAGAA-1	DC
ATACCGATCTACGGTA-1	Macrophages
ATACCTTAGCGGACAT-1	T cells
ATACCTTCACTGGCCA-1	T cells
ATACCTTGTCATAACC-1	T cells
ATACCTTTCGGAATTC-1	T cells
ATACTTCAGGTCTTTG-1	T cells
ATACTTCCAACAGCTT-1	Epithelial cells
ATACTTCCAACGACTT-1	NK cells
ATACTTCGTAACATCC-1	T cells
ATACTTCGTAGTCGGA-1	T cells
ATACTTCGTTATTCTC-1	T cells
ATACTTCTCCAACTAG-1	T cells
ATACTTCTCCATACAG-1	T cells
ATACTTCTCCTAGCTC-1	Epithelial cells
ATACTTCTCGATCCCT-1	Epithelial cells
ATAGACCAGTTAGTAG-1	T cells
ATAGACCGTGAGATCG-1	T cells
ATAGACCTCATTACCT-1	Epithelial cells
ATAGACCTCGGCCTTT-1	T cells
ATAGACCTCGGTCACG-1	B cells
ATAGACCTCTGGTGGC-1	T cells
ATAGAGACAACTCGTA-1	DC
ATAGAGACATAGGCGA-1	T cells
ATAGAGACATCAGCTA-1	DC
ATAGAGAGTCCGGTGT-1	T cells
ATAGGCTCAGATTTCG-1	T cells
ATAGGCTCATCGTCCT-1	T cells
ATAGGCTGTACCCGAC-1	Epithelial cells
ATAGGCTGTAGCCAGA-1	T cells
ATAGGCTGTCTGGTTA-1	T cells
ATAGGCTTCCACAGCG-1	Epithelial cells
ATAGGCTTCTGCACCT-1	T cells
ATAGGCTTCTTTGCGC-1	Epithelial cells
ATATCCTAGACTACCT-1	Plasma cells
ATATCCTAGCGCCTCA-1	T cells
ATATCCTCAAGCTCTA-1	T cells
ATATCCTCAGGAACCA-1	T cells
ATATCCTGTGTCCAAT-1	Epithelial cells
ATATCCTTCACCTCTG-1	T cells
ATCACAGAGCAACTCT-1	Epithelial cells
ATCACAGCAGCATCTA-1	Epithelial cells
ATCACAGGTCTCGCGA-1	DC
ATCACAGGTGGAACAC-1	Epithelial cells
ATCACAGGTGGGACAT-1	Epithelial cells
ATCACAGGTTGGCCTG-1	T cells
ATCACAGTCAACGCTA-1	T cells
ATCACAGTCAGGAACG-1	T cells
ATCACGAAGAGAGAAC-1	T cells
ATCACGAAGGAGCAAA-1	Epithelial cells
ATCACGACAGCTCTGG-1	T cells
ATCACGAGTACCACGC-1	T cells
ATCACGATCGACGCTG-1	T cells
ATCACTTAGGTTAAAC-1	NK cells
ATCACTTCACCAAATC-1	T cells
ATCACTTCAGGCCCTA-1	Epithelial cells
ATCACTTGTAGGGTAC-1	T cells
ATCACTTGTCGATTAC-1	T cells
ATCACTTGTGGGAGAG-1	Epithelial cells
ATCACTTTCATTCGTT-1	T cells
ATCACTTTCTCTCTTC-1	Epithelial cells
ATCAGGTAGGTCCCTG-1	NK cells
ATCAGGTCACCTGCAG-1	T cells
ATCAGGTCATGGGTTT-1	Epithelial cells
ATCAGGTGTGTCTTCC-1	pDC
ATCAGGTTCCTCAGGG-1	T cells
ATCAGGTTCCTCTAGC-1	T cells
ATCATTCAGTTGTAAG-1	Epithelial cells
ATCATTCCACCGTGAC-1	Fibroblasts
ATCATTCCACGGGTAA-1	T cells
ATCATTCCAGACAAGC-1	T cells
ATCATTCGTACGAGCA-1	Monocytes
ATCATTCTCAACCGAT-1	B cells
ATCATTCTCCGATGCG-1	T cells
ATCATTCTCTTTGCTA-1	T cells
ATCCACCCACCTAAAC-1	T cells
ATCCACCCAGATAAAC-1	Epithelial cells
ATCCACCGTCATGACT-1	T cells
ATCCACCGTGCTCTCT-1	Epithelial cells
ATCCACCTCGGTATGT-1	NK cells
ATCCACCTCTTGGATG-1	Epithelial cells
ATCCATTAGCGTCAGA-1	T cells
ATCCATTGTGCATGAG-1	Epithelial cells
ATCCATTGTGTCCAAT-1	T cells
ATCCATTTCGTTGCCT-1	T cells
ATCCCTGCAGCGTAGA-1	DC
ATCCCTGCAGTTAGGG-1	T cells
ATCCCTGGTACAGTAA-1	T cells
ATCCCTGTCAGACATC-1	T cells
ATCCCTGTCTACCTTA-1	DC
ATCCGTCAGTTATGGA-1	T cells
ATCCGTCCAAGGTCAG-1	Endothelial cells
ATCCGTCCAAGTCGTT-1	DC
ATCCGTCGTCGCAACC-1	Epithelial cells
ATCCGTCGTGCGGTAA-1	T cells
ATCCGTCTCTAGGCAT-1	Epithelial cells
ATCCGTCTCTATACTC-1	T cells
ATCCTATAGACCGCCT-1	Fibroblasts
ATCCTATCATGACGTT-1	T cells
ATCCTATGTCCAAGAG-1	T cells
ATCCTATTCGTTTACT-1	T cells
ATCGATGAGGATTTGA-1	T cells
ATCGATGAGTTACGAA-1	T cells
ATCGATGCACCGGAAA-1	B cells
ATCGATGCATGCCGCA-1	Epithelial cells
ATCGATGCATTGACAC-1	T cells
ATCGATGGTACCAATC-1	Epithelial cells
ATCGATGTCAAAGCCT-1	T cells
ATCGCCTAGAGAGCGG-1	T cells
ATCGCCTCAGGTCTCG-1	Epithelial cells
ATCGCCTGTCCAAAGG-1	T cells
ATCGCCTTCTTCTAAC-1	DC
ATCGGATAGCCGTTAT-1	Epithelial cells
ATCGGATAGGCTCTAT-1	NK cells
ATCGGATCAGCCCAGT-1	T cells
ATCGGATCATATCTGG-1	T cells
ATCGGATGTATTAAGG-1	T cells
ATCGGATGTATTCCTT-1	B cells
ATCGGATGTCTACTGA-1	Epithelial cells
ATCGGATTCGAGCACC-1	NK cells
ATCGGATTCGGCGATC-1	T cells
ATCGGCGCAAGACCGA-1	T cells
ATCGGCGCACCTGCAG-1	Epithelial cells
ATCGGCGCAGGCTCTG-1	T cells
ATCGGCGGTCATCAGT-1	Epithelial cells
ATCGGCGGTGCAACGA-1	B cells
ATCGTAGAGTCGGCAA-1	NK cells
ATCGTAGCAGATCACT-1	pDC
ATCGTAGGTCAAGCCC-1	T cells
ATCGTAGGTCCGACGT-1	T cells
ATCGTAGGTTATAGAG-1	T cells
ATCGTAGGTTCCAAAC-1	Macrophages
ATCGTAGTCACAGTGT-1	T cells
ATCGTCCCAACAGTGG-1	Monocytes
ATCGTCCTCCAGCAAT-1	T cells
ATCGTGAGTACTGACT-1	Epithelial cells
ATCGTGAGTATCAAGA-1	T cells
ATCGTGAGTCTATGAC-1	Fibroblasts
ATCGTGAGTTCGGTAT-1	Epithelial cells
ATCGTGATCGCATAGT-1	Monocytes
ATCTCTAAGTAAACAC-1	Epithelial cells
ATCTCTAAGTCGCGAA-1	Epithelial cells
ATCTCTACACATGTTG-1	NK cells
ATCTCTACACTAGGTT-1	pDC
ATCTCTACAGCACAGA-1	B cells
ATCTCTAGTGAGATCG-1	T cells
ATCTCTATCCAAGCCG-1	T cells
ATCTCTATCTACTTCA-1	T cells
ATCTCTATCTAGTGTG-1	B cells
ATCTTCAAGGCTAAAT-1	Epithelial cells
ATCTTCAAGTGAGTGC-1	T cells
ATCTTCAGTGCAGGAT-1	Epithelial cells
ATCTTCATCAGGAGAC-1	NK cells
ATCTTCATCGCATGAT-1	T cells
ATCTTCATCGGTTGTA-1	T cells
ATCTTCATCTCTTGCG-1	T cells
ATGAAAGCATGTGCCG-1	T cells
ATGAAAGCATTCATCT-1	T cells
ATGAAAGGTAGAGACC-1	Fibroblasts
ATGAAAGTCAGCAATC-1	Monocytes
ATGAAAGTCTACGCGG-1	T cells
ATGAAAGTCTTGGAAC-1	Epithelial cells
ATGACCACAGTCGAGA-1	T cells
ATGACCACATACCACA-1	Epithelial cells
ATGACCATCGAGCCTG-1	T cells
ATGAGGGAGAACAGGA-1	T cells
ATGAGGGAGGACTTCT-1	T cells
ATGAGGGAGGTATTGA-1	NK cells
ATGAGGGAGGTCCCGT-1	T cells
ATGAGGGCACGTAGAG-1	Macrophages
ATGAGGGCACTAACCA-1	Epithelial cells
ATGAGGGCATGGCACC-1	B cells
ATGAGGGTCCTATTTG-1	T cells
ATGAGGGTCTGAGTCA-1	Macrophages
ATGAGTCAGCTCTTCC-1	Macrophages
ATGAGTCAGGGTGAAA-1	NK cells
ATGAGTCAGTCATCCA-1	DC
ATGAGTCGTACAAAGT-1	Macrophages
ATGAGTCGTCGTGGTC-1	T cells
ATGAGTCTCATCTATC-1	T cells
ATGATCGCAACCAACT-1	NK cells
ATGATCGCAAGGCGTA-1	Epithelial cells
ATGATCGCACATAACC-1	T cells
ATGATCGTCCCGTGAG-1	T cells
ATGATCGTCCGTAATG-1	T cells
ATGATCGTCTGCGAGC-1	DC
ATGCATGAGAAGGTAG-1	T cells
ATGCATGAGACTGGGT-1	Epithelial cells
ATGCATGAGGTGATCG-1	T cells
ATGCATGCAAGCTGCC-1	T cells
ATGCATGCAATAACGA-1	T cells
ATGCATGCAGACATCT-1	Macrophages
ATGCATGGTATGGGAC-1	T cells
ATGCATGTCCATCCGT-1	T cells
ATGCCTCAGCATTTGC-1	DC
ATGCCTCAGTAAACGT-1	Fibroblasts
ATGCCTCCAGCTACCG-1	T cells
ATGCCTCCATGGCTAT-1	T cells
ATGCCTCCATTCCTAT-1	Macrophages
ATGCGATAGTGTCATC-1	NK cells
ATGCGATCAACGGGTA-1	NK cells
ATGCGATCAAGAAATC-1	Fibroblasts
ATGCGATCAGGGCTTC-1	T cells
ATGCGATTCATTACCT-1	Macrophages
ATGCGATTCCCTGTTG-1	Epithelial cells
ATGCGATTCCTGTACC-1	T cells
ATGGAGGAGCGCATCC-1	NK cells
ATGGAGGAGGCATCGA-1	Endothelial cells
ATGGAGGCACACCAGC-1	T cells
ATGGAGGGTCCAAGAG-1	Epithelial cells
ATGGAGGTCCTAAACG-1	Epithelial cells
ATGGATCGTAAGGCTG-1	Epithelial cells
ATGGATCTCGTAACAC-1	NK cells
ATGGGAGAGGACTATA-1	Epithelial cells
ATGGGAGAGGTTCACT-1	DC
ATGGGAGTCGAGAGAC-1	T cells
ATGGGTTAGCAATAAC-1	T cells
ATGGGTTCATTGCTGA-1	Macrophages
ATGGGTTGTTCCTACC-1	B cells
ATGGGTTGTTGACGGA-1	T cells
ATGGGTTTCCATCCGT-1	Monocytes
ATGGGTTTCCCTTTGG-1	B cells
ATGGTTGAGAGGTATT-1	T cells
ATGGTTGCAATGTTGC-1	Epithelial cells
ATGGTTGCACACAGAG-1	Epithelial cells
ATGGTTGGTATTTCCT-1	T cells
ATGGTTGGTGTTAGCT-1	Epithelial cells
ATGGTTGTCAGTAGGG-1	Epithelial cells
ATGGTTGTCCCTCGAT-1	NK cells
ATGTCCCCAATTGGTC-1	Epithelial cells
ATGTCCCCACTAGGCC-1	DC
ATGTCCCCATAATGCC-1	DC
ATGTCCCGTATACCCA-1	T cells
ATGTCCCTCAGAACCT-1	Epithelial cells
ATGTCCCTCCTTTAGT-1	T cells
ATGTCCCTCGACCACG-1	T cells
ATGTCCCTCGGCTGGT-1	NK cells
ATGTCCCTCGTAATGC-1	Epithelial cells
ATGTCCCTCTGGAGAG-1	Epithelial cells
ATGTCTTCACATGTTG-1	DC
ATGTCTTCACGATAGG-1	Macrophages
ATTACCTAGGGATCTG-1	Monocytes
ATTACCTAGGTTACCT-1	Epithelial cells
ATTACCTGTTATTCTC-1	NK cells
ATTACCTGTTTGAAAG-1	Epithelial cells
ATTACCTTCACTCGAA-1	T cells
ATTACCTTCTTTGCAT-1	T cells
ATTACTCAGGCACTCC-1	T cells
ATTACTCAGGTGCCAA-1	T cells
ATTACTCGTCAGCTTA-1	DC
ATTACTCGTTCGTAAC-1	T cells
ATTATCCAGCTCTGTA-1	T cells
ATTATCCCACTCCCTA-1	T cells
ATTATCCCAGCATGCC-1	T cells
ATTATCCGTCTTTCAT-1	T cells
ATTCACTAGCTAAACA-1	Monocytes
ATTCACTGTCCGAAAG-1	T cells
ATTCACTGTCGAGTGA-1	T cells
ATTCACTTCAAGCGTT-1	Epithelial cells
ATTCACTTCCTCAGGG-1	B cells
ATTCACTTCCTCTCTT-1	T cells
ATTCACTTCGCCTCTA-1	Macrophages
ATTCAGGCACACCTGG-1	T cells
ATTCAGGCACGATTCA-1	Epithelial cells
ATTCAGGCAGGGTTGA-1	T cells
ATTCAGGCAGTGGTGA-1	T cells
ATTCATCAGAACAAGG-1	T cells
ATTCATCAGTCACTCA-1	T cells
ATTCATCCAGGTATGG-1	Macrophages
ATTCATCGTACATTGC-1	T cells
ATTCATCGTCTACACA-1	Macrophages
ATTCATCGTTAAGACA-1	T cells
ATTCATCTCATTGCTT-1	T cells
ATTCATCTCCTGGGAC-1	T cells
ATTCCATAGAGCCGAT-1	Epithelial cells
ATTCCATCAAGGCCTC-1	Epithelial cells
ATTCCATCACCTTCGT-1	T cells
ATTCCATCAGGCTACC-1	DC
ATTCCATGTCGCCACA-1	pDC
ATTCCCGAGAGGGTCT-1	T cells
ATTCCCGAGGTCACAG-1	T cells
ATTCCCGTCCTCTCGA-1	Epithelial cells
ATTCCTAAGCCTATTG-1	T cells
ATTCCTAAGGGACACT-1	T cells
ATTCCTAAGGTCACCC-1	T cells
ATTCCTAGTGGGTTGA-1	T cells
ATTCCTATCCAACACA-1	Macrophages
ATTCCTATCTAGCCAA-1	pDC
ATTCGTTAGATGGGCT-1	Fibroblasts
ATTCGTTCATAGATGA-1	B cells
ATTCGTTGTACTAACC-1	T cells
ATTCGTTGTCGGTGTC-1	Macrophages
ATTCGTTGTGGTCCCA-1	T cells
ATTCGTTTCGGTGAAG-1	Monocytes
ATTCTACCAAGTACCT-1	T cells
ATTCTTGAGAATGTTG-1	Monocytes
ATTCTTGGTTGGAGGT-1	T cells
ATTGGGTAGCAACCAG-1	Macrophages
ATTGGGTAGCAGCGAT-1	DC
ATTGGGTGTAATTGGA-1	T cells
ATTGGGTGTACGTACT-1	Epithelial cells
ATTGGGTTCCACAGGC-1	Epithelial cells
ATTGTTCGTCTCAAGT-1	T cells
ATTGTTCGTTCATCTT-1	Epithelial cells
ATTGTTCGTTGCTGAT-1	B cells
ATTTACCAGCCTGAAG-1	Epithelial cells
ATTTACCCATCCGCGA-1	T cells
ATTTACCGTGCGGTAA-1	B cells
ATTTACCGTGTTCCTC-1	DC
ATTTACCTCAGTGGGA-1	T cells
ATTTCACAGAGTCTGG-1	Epithelial cells
ATTTCACAGTAGACCG-1	Epithelial cells
ATTTCACCAGATACTC-1	T cells
ATTTCACCATCCGCGA-1	T cells
ATTTCACCATTGGGAG-1	Fibroblasts
ATTTCACGTCTGTGCG-1	T cells
ATTTCACGTTATCTTC-1	Epithelial cells
ATTTCACTCAAGGTGG-1	Epithelial cells
ATTTCACTCGCACTCT-1	T cells
ATTTCTGAGCAGATAT-1	T cells
ATTTCTGAGGTGCCTC-1	T cells
ATTTCTGCAAGTCCCG-1	Macrophages
ATTTCTGCACGTGAGA-1	T cells
ATTTCTGGTCCCTCAT-1	T cells
ATTTCTGTCGCTACAA-1	Epithelial cells
CAAAGAAAGACTCTAC-1	Epithelial cells
CAAAGAAAGCTCGTGC-1	pDC
CAAAGAAAGTCACGCC-1	Endothelial cells
CAAAGAAAGTTGTCGT-1	NK cells
CAAAGAACAGACAAGC-1	Macrophages
CAAAGAAGTGGTTCTA-1	T cells
CAACAACCACAACCGC-1	Macrophages
CAACAACGTGGCCTCA-1	T cells
CAACAACTCTACGGGC-1	T cells
CAACAGTAGTAGGCCA-1	Plasma cells
CAACAGTCAGCGTGCT-1	Macrophages
CAACAGTTCGACATCA-1	Macrophages
CAACCAAGTGAGACGT-1	T cells
CAACCAATCCGTTGAA-1	T cells
CAACCAATCGTTCTGC-1	T cells
CAACCTCAGCGTATAA-1	Macrophages
CAACCTCAGGTAGCAC-1	B cells
CAACCTCAGGTGATCG-1	Epithelial cells
CAACCTCCAAGTTTGC-1	pDC
CAACCTCCACAATGTC-1	T cells
CAACCTCCATGAGAAT-1	T cells
CAACCTCGTATGTGTC-1	T cells
CAACCTCGTCAAAGAT-1	T cells
CAACCTCGTCGACTGC-1	Fibroblasts
CAACGATAGCCACTCG-1	T cells
CAACGATAGTCATTGC-1	DC
CAACGATCACAACCGC-1	T cells
CAACGATCACAGTACT-1	Epithelial cells
CAACGATCATGACAGG-1	T cells
CAACGATGTCTACACA-1	T cells
CAACGATGTGTGCTTA-1	Fibroblasts
CAACGATGTTAAGACA-1	pDC
CAACGATGTTCGATTG-1	Epithelial cells
CAACGATGTTCTTCAT-1	T cells
CAACGATGTTTGAAAG-1	T cells
CAACGATTCAGGAACG-1	Epithelial cells
CAACGATTCAGTGATC-1	T cells
CAACGATTCTTGGGCG-1	Monocytes
CAACGGCAGCATCCTA-1	T cells
CAACGGCAGCTGCCTG-1	T cells
CAACGGCAGTCTAGCT-1	Macrophages
CAACGGCCAACGATCT-1	T cells
CAACGGCGTCACTTCC-1	T cells
CAACGGCTCCGGTTCT-1	T cells
CAAGACTAGGGATCAC-1	NK cells
CAAGACTCACTCCCTA-1	Fibroblasts
CAAGACTCAGCAGTTT-1	Epithelial cells
CAAGAGGGTACTTGTG-1	B cells
CAAGAGGGTCGTACTA-1	pDC
CAAGAGGGTGGGACAT-1	NK cells
CAAGAGGTCGGCACTG-1	pDC
CAAGCTAAGACGCCAA-1	Epithelial cells
CAAGCTAAGGCTAAAT-1	Epithelial cells
CAAGCTACAAGAATGT-1	Epithelial cells
CAAGCTACAGCGGTCT-1	T cells
CAAGCTAGTTCTCGTC-1	T cells
CAAGGGAAGCTGTTCA-1	Epithelial cells
CAAGGGAAGGATGGCT-1	T cells
CAAGGGAGTCTACTGA-1	Macrophages
CAAGGGAGTTATGTGC-1	NK cells
CAAGGGAGTTTGATCG-1	T cells
CAATACGAGAAGAGCA-1	Fibroblasts
CAATACGGTGTGATGG-1	Epithelial cells
CAATACGGTTGTTGCA-1	T cells
CAATACGTCCAGCTCT-1	T cells
CAATACGTCGACCAAT-1	T cells
CAATCGAAGAGGATGA-1	T cells
CAATCGACAATCGTCA-1	T cells
CAATCGACAGAACTTC-1	Epithelial cells
CAATCGACAGGGAATC-1	T cells
CAATCGATCGCCACTT-1	T cells
CAATGACAGGGCTGAT-1	T cells
CAATGACCAGAAATTG-1	T cells
CAATGACGTGACCGTC-1	T cells
CAATGACTCATGGAGG-1	Fibroblasts
CAATTTCAGCACTAAA-1	Macrophages
CAATTTCAGTTTGCTG-1	T cells
CAATTTCCAACCCTCT-1	T cells
CAATTTCTCACTACTT-1	DC
CAATTTCTCCCGAACG-1	Fibroblasts
CACAACAAGTCATGGG-1	T cells
CACAACACAGAGAATT-1	B cells
CACAACACATACAGGG-1	Epithelial cells
CACAACAGTCCGAAAG-1	T cells
CACAACAGTTTCCAAG-1	Epithelial cells
CACAACATCAGCTGAT-1	Macrophages
CACAACATCCAGGACC-1	Macrophages
CACAACATCTCGTCGT-1	T cells
CACAACATCTGGGAGA-1	T cells
CACACAAAGCTGCCAC-1	Macrophages
CACACAACACGCGTGT-1	T cells
CACACAACAGGCACTC-1	T cells
CACACAACATAATGAG-1	Epithelial cells
CACACAATCCTAGCGG-1	T cells
CACAGATAGTATGCAA-1	Epithelial cells
CACAGATAGTTCTACG-1	T cells
CACAGATCAAACCACT-1	Macrophages
CACAGATCACCCTGAG-1	DC
CACAGATGTACGATGG-1	T cells
CACAGATGTCATACCA-1	pDC
CACAGATGTCGCCTAG-1	NK cells
CACAGATTCGCCTTGT-1	T cells
CACAGATTCTACGGGC-1	T cells
CACAGGCCATAGAAAC-1	T cells
CACAGGCGTAACCCTA-1	T cells
CACAGGCTCGGCTGAC-1	Macrophages
CACATGAAGTTGAATG-1	T cells
CACATGACATCAGCGC-1	T cells
CACATGAGTTCGGCTG-1	B cells
CACATGATCGACCCAG-1	NK cells
CACCAAAAGCTGACTT-1	Epithelial cells
CACCAAAAGCTTTCCC-1	T cells
CACCAAAAGTAGCCAG-1	T cells
CACCAAACACAGTCCG-1	Epithelial cells
CACCAAACACATATCG-1	Macrophages
CACCAAAGTGACCTGC-1	Macrophages
CACCAAAGTGCTGTCG-1	T cells
CACCAAATCGTACCTC-1	Macrophages
CACCGTTCATGGGATG-1	T cells
CACCGTTGTCCACAGC-1	T cells
CACCGTTGTCTGTCAA-1	T cells
CACCGTTGTGAGACGT-1	T cells
CACCGTTTCCGACGGT-1	Epithelial cells
CACGAATAGCGAACTG-1	T cells
CACGAATAGGGTTGCA-1	T cells
CACGAATCACTACACA-1	pDC
CACGAATGTGAATGAT-1	Mast cells
CACGAATGTGAGATAT-1	Macrophages
CACGGGTAGAAGAACG-1	Epithelial cells
CACGGGTAGCGCAATG-1	T cells
CACGGGTCATGCCGAC-1	Macrophages
CACGGGTGTACATTGC-1	T cells
CACGGGTGTCAAAGCG-1	Epithelial cells
CACGGGTGTGCGAACA-1	Epithelial cells
CACGGGTGTTTGTTGG-1	T cells
CACGGGTTCAAGAGGC-1	Endothelial cells
CACGGGTTCATAGGCT-1	T cells
CACGGGTTCTGGAAGG-1	Macrophages
CACGGGTTCTGGGCGT-1	T cells
CACGTGGAGGCGTTAG-1	T cells
CACGTGGAGTTACGTC-1	T cells
CACGTGGGTCGTTGCG-1	Epithelial cells
CACGTGGGTTCGATTG-1	T cells
CACGTGGTCCAAACCA-1	NK cells
CACGTGGTCCACAAGT-1	Epithelial cells
CACGTGGTCCCTCGTA-1	T cells
CACGTTCAGATGCCGA-1	T cells
CACGTTCAGCAACAAT-1	Macrophages
CACGTTCAGCAGAAAG-1	Epithelial cells
CACGTTCCATGCCGAC-1	DC
CACGTTCGTCCGGTCA-1	Monocytes
CACGTTCTCACGTAGT-1	T cells
CACTAAGAGAGGTGCT-1	T cells
CACTAAGCAACCGATT-1	T cells
CACTAAGCACAAACGG-1	T cells
CACTAAGCATAAGCAA-1	B cells
CACTAAGGTGCTTCAA-1	T cells
CACTGAAAGTACTGGG-1	Monocytes
CACTGAACAACTGTGT-1	T cells
CACTGAATCGAGAAGC-1	Epithelial cells
CACTGAATCGTAGAGG-1	Macrophages
CACTGAATCTTCACGC-1	T cells
CACTGGGCACTCTAGA-1	Epithelial cells
CACTGGGCAGAGACTG-1	T cells
CACTGGGCAGTTTCGA-1	T cells
CACTGGGCATTGCCTC-1	T cells
CACTGGGGTAACCCGC-1	Monocytes
CACTGGGGTTGCTCGG-1	Monocytes
CACTGGGTCACTGTCC-1	Epithelial cells
CACTGGGTCTCCAAGA-1	DC
CACTGTCGTACAGTTC-1	T cells
CACTGTCGTAGCTGCC-1	Monocytes
CACTGTCTCATTGCGA-1	NK cells
CACTGTCTCCCATACC-1	T cells
CACTGTCTCCTCTAAT-1	Macrophages
CACTTCGAGTCTGGAG-1	Epithelial cells
CACTTCGCACGTCTCT-1	T cells
CACTTCGGTTCCGCTT-1	DC
CACTTCGGTTCCGGTG-1	NK cells
CACTTCGGTTCTTGTT-1	T cells
CACTTCGGTTGTTGCA-1	Epithelial cells
CACTTCGTCAGGCGAA-1	Fibroblasts
CAGAGCCAGCAGCCTC-1	T cells
CAGAGCCCAAGATTGA-1	NK cells
CAGAGCCGTCCTTGTC-1	Epithelial cells
CAGAGCCGTGTTGATC-1	NK cells
CAGAGCCGTTCAAGGG-1	T cells
CAGAGCCGTTTAGAGA-1	Epithelial cells
CAGAGCCTCATCCTAT-1	Macrophages
CAGAGCCTCCGCCTAT-1	T cells
CAGATACAGAAGCGAA-1	T cells
CAGATACAGATTCGCT-1	DC
CAGATACAGCGTGAAC-1	T cells
CAGATACAGCTGGCCT-1	T cells
CAGATACAGGGTAGCT-1	NK cells
CAGATACCACGTTGGC-1	T cells
CAGATACGTTTCGCTC-1	T cells
CAGATACTCAAAGACA-1	Macrophages
CAGATCAAGAGGGTCT-1	T cells
CAGATCACACAGTGTT-1	Fibroblasts
CAGATCAGTCACCCTT-1	Epithelial cells
CAGATCATCGCTATTT-1	T cells
CAGATCATCGTCACCT-1	T cells
CAGATTGAGAGAACCC-1	T cells
CAGATTGCATATAGCC-1	T cells
CAGATTGGTTTGAAAG-1	T cells
CAGATTGTCACCGGTG-1	T cells
CAGCAATAGGATACCG-1	Endothelial cells
CAGCAATCAAAGGGTC-1	T cells
CAGCAATCACTCCCTA-1	T cells
CAGCAATGTCGCAACC-1	T cells
CAGCAATGTTGTCAGT-1	T cells
CAGCAATTCTGCCTGT-1	T cells
CAGCACGAGGGCAAGG-1	T cells
CAGCACGCATGACGGA-1	T cells
CAGCACGGTACCCAGC-1	T cells
CAGCACGGTGGCTGCT-1	Epithelial cells
CAGCACGGTTGGTAGG-1	T cells
CAGCACGTCACCATCC-1	Epithelial cells
CAGCACGTCACGGTCG-1	Macrophages
CAGCACGTCAGTGTCA-1	T cells
CAGCACGTCCTGGGAC-1	T cells
CAGCAGCGTCAGACTT-1	NK cells
CAGCAGCTCCATATGG-1	Epithelial cells
CAGCAGCTCCCATTCG-1	T cells
CAGCCAGAGGACTAAT-1	T cells
CAGCCAGAGGATGAGA-1	Macrophages
CAGCCAGCAATCTCTT-1	T cells
CAGCCAGCACCGTGGT-1	T cells
CAGCCAGCACGCAAAG-1	Epithelial cells
CAGCCAGCACTCTGCT-1	T cells
CAGCCAGGTAGACACG-1	NK cells
CAGCCAGGTCTAATCG-1	T cells
CAGCCAGTCGTTGTGA-1	Monocytes
CAGCGTGCATTGCCGG-1	NK cells
CAGCGTGGTCCGGACT-1	T cells
CAGCGTGTCCACACCT-1	DC
CAGCGTGTCCATCGTC-1	T cells
CAGCGTGTCGTCGCTT-1	T cells
CAGCGTGTCTCGGCTT-1	T cells
CAGCGTGTCTGGCCAG-1	NK cells
CAGGCCAAGAATCGCG-1	Epithelial cells
CAGGCCACAACACACT-1	Epithelial cells
CAGGCCACAGCGCGTT-1	Epithelial cells
CAGGCCAGTCTACACA-1	Fibroblasts
CAGGCCATCGTGTGGC-1	Macrophages
CAGGGCTAGTATTAGG-1	Epithelial cells
CAGGGCTAGTGTAGTA-1	T cells
CAGGGCTCAAGCACCC-1	T cells
CAGGGCTCACGGCCAT-1	T cells
CAGGGCTCAGCATGCC-1	Epithelial cells
CAGGGCTCAGCTAACT-1	T cells
CAGGGCTCATCCGATA-1	T cells
CAGGGCTGTACAAAGT-1	Macrophages
CAGGGCTTCACCTTGC-1	T cells
CAGGGCTTCAGCAGAG-1	T cells
CAGGGCTTCCCAAGTA-1	Epithelial cells
CAGGTATAGGAACGAA-1	Macrophages
CAGGTATGTATGGAAT-1	Macrophages
CAGGTATTCCGCGAGT-1	Macrophages
CAGGTATTCCGTGGCA-1	T cells
CAGTGCGAGAGCCCAA-1	T cells
CAGTGCGAGCCACAAG-1	T cells
CAGTGCGAGCTTACGT-1	DC
CAGTGCGAGGTCCGAA-1	T cells
CAGTGCGCATGATCTG-1	Epithelial cells
CAGTGCGCATGTGACT-1	Epithelial cells
CAGTGCGGTCAGTCCG-1	NK cells
CAGTGCGGTCTGTCAA-1	T cells
CAGTGCGGTCTTAGTG-1	T cells
CAGTGCGGTTACGGAG-1	Macrophages
CAGTGCGTCTTAGCTT-1	Epithelial cells
CAGTGCGTCTTGGAAC-1	Macrophages
CAGTTAGAGTAAACGT-1	Epithelial cells
CAGTTAGGTCAACGCC-1	Epithelial cells
CAGTTAGTCCCATGGG-1	NK cells
CAGTTAGTCGCTACGG-1	DC
CAGTTCCCAAGACCGA-1	Endothelial cells
CAGTTCCGTCAGTCGC-1	T cells
CAGTTCCGTTCCACAA-1	B cells
CAGTTCCTCAGGAAGC-1	NK cells
CAGTTCCTCCCAGCGA-1	T cells
CATAAGCCACAAAGCG-1	T cells
CATAAGCCACACTGGC-1	Epithelial cells
CATAAGCCACTCCGAG-1	Epithelial cells
CATAAGCCATTCTCCG-1	T cells
CATAAGCGTCCAGAAG-1	Macrophages
CATAAGCGTTCCGGTG-1	Monocytes
CATAAGCTCTCCTGAC-1	B cells
CATACAGAGACGTCCC-1	Epithelial cells
CATACAGAGACTGGGT-1	T cells
CATACAGAGCAGGTCA-1	T cells
CATACAGAGCTTTCTT-1	T cells
CATACAGCAGCGAGTA-1	Epithelial cells
CATACAGCAGTCAACT-1	NK cells
CATACAGGTACAAGTA-1	T cells
CATACAGGTACTGAGG-1	T cells
CATACAGTCAATCCGA-1	T cells
CATACCCAGAACCGCA-1	T cells
CATACCCAGGTCACTT-1	NK cells
CATACCCGTACACTCA-1	T cells
CATACCCGTGCCTAAT-1	Macrophages
CATACCCTCCGATTAG-1	T cells
CATACCCTCGGAAGGT-1	T cells
CATACTTAGCTCGACC-1	T cells
CATACTTGTACAAAGT-1	T cells
CATACTTTCAGCGCAC-1	T cells
CATAGACAGGTAGACC-1	Macrophages
CATCAAGAGGGACAGG-1	Plasma cells
CATCAAGAGTGCGACA-1	T cells
CATCAAGCAAGAGCTG-1	T cells
CATCAAGGTTACACAC-1	T cells
CATCCACAGATAGTCA-1	Epithelial cells
CATCCACCAGACATCT-1	T cells
CATCCACGTAAGGCTG-1	T cells
CATCCCAAGAATTCAG-1	Fibroblasts
CATCCCAAGTCGCCCA-1	T cells
CATCCCAAGTGGTTCT-1	pDC
CATCCCAGTATCAGGG-1	T cells
CATCCCAGTCGGTGAA-1	Epithelial cells
CATCCCAGTTAATCGC-1	NK cells
CATCCCATCCTCCACA-1	Epithelial cells
CATCCGTAGGCGCTCT-1	T cells
CATCCGTCAATAGTCC-1	Epithelial cells
CATCCGTTCGACGATT-1	T cells
CATCGCTAGTAACCTC-1	T cells
CATCGCTGTCGATTTG-1	T cells
CATCGCTGTTGCTAGT-1	Plasma cells
CATCGCTTCACAATGC-1	T cells
CATCGCTTCCGTCCTA-1	Fibroblasts
CATCGCTTCGATCCAA-1	T cells
CATCGCTTCTAGACAC-1	Macrophages
CATCGGGAGATGCCGA-1	T cells
CATCGGGAGTGGCAGT-1	NK cells
CATCGGGGTCGAATTC-1	Epithelial cells
CATCGTCAGACAGCTG-1	T cells
CATCGTCCATTGCCTC-1	T cells
CATCGTCTCAGACCCG-1	T cells
CATCGTCTCGCCAGTG-1	NK cells
CATGAGTAGTAGGATT-1	T cells
CATGAGTCAGCTGAGA-1	T cells
CATGAGTCAGGCATGA-1	T cells
CATGAGTGTATCGAAA-1	B cells
CATGAGTTCGGAATTC-1	T cells
CATGCAAAGACTAAGT-1	pDC
CATGCAAAGCCAACCC-1	DC
CATGCAAAGCCTGAGA-1	T cells
CATGCAAGTCCACACG-1	T cells
CATGCAATCCACGGGT-1	Monocytes
CATGCAATCGCAGATT-1	T cells
CATGCCTAGCTGTGCC-1	T cells
CATGCCTAGTCCTACA-1	Epithelial cells
CATGCCTTCCAATGCA-1	Fibroblasts
CATGCCTTCCTCTAAT-1	T cells
CATGCCTTCGACATAC-1	T cells
CATGCCTTCGCTACGG-1	T cells
CATGCGGAGCGAACTG-1	T cells
CATGCGGCAACTCCCT-1	Epithelial cells
CATGCGGGTTCTTCAT-1	pDC
CATGCGGTCACTGATG-1	Monocytes
CATGCTCAGTCTAACC-1	T cells
CATGCTCAGTGGCGAT-1	Macrophages
CATGCTCGTTGGGAAC-1	Macrophages
CATGGATCAACCTAAC-1	T cells
CATGGATCAGTACTAC-1	T cells
CATGGATGTAGCTCGC-1	T cells
CATGGATTCGCGCTGA-1	T cells
CATGGTAAGAGTCAAT-1	T cells
CATGGTAAGGAAAGAC-1	Fibroblasts
CATGGTAAGGGCATGT-1	Fibroblasts
CATGGTAAGGGCTTCC-1	Epithelial cells
CATGGTACACCCTGAG-1	Epithelial cells
CATGGTACATATGAAG-1	Macrophages
CATGGTAGTCCTACAA-1	Epithelial cells
CATGGTAGTCCTACGG-1	T cells
CATGGTAGTCTTCGAA-1	Endothelial cells
CATGGTAGTGGTACAG-1	Monocytes
CATGGTAGTTAAGCAA-1	pDC
CATGGTAGTTTACACG-1	pDC
CATGGTATCACACGAT-1	Epithelial cells
CATGGTATCACGGAGA-1	pDC
CATGGTATCGCTCTCA-1	T cells
CATGGTATCTTAGCAG-1	T cells
CATTCATAGAATCTAG-1	T cells
CATTCATCATGTCTAG-1	T cells
CATTCATGTCGTATGT-1	T cells
CATTCATGTGGCTTGC-1	DC
CATTCATGTTACACAC-1	Fibroblasts
CATTCATTCCATCTCG-1	T cells
CATTCATTCGCCTATC-1	Epithelial cells
CATTCATTCGCTACGG-1	DC
CATTCATTCGGAAACG-1	B cells
CATTCATTCTACGGGC-1	T cells
CATTCATTCTAGCATG-1	Monocytes
CATTCCGAGAGTTCGG-1	T cells
CATTCCGAGCCTCCAG-1	T cells
CATTCCGGTATGAGCG-1	T cells
CATTCCGGTGCGGTAA-1	B cells
CATTCCGGTTACGATC-1	T cells
CATTCCGTCATGTCAG-1	Epithelial cells
CATTCCGTCGATGGAG-1	T cells
CATTCTAAGATAGCTA-1	Epithelial cells
CATTCTAAGGAGTACC-1	Macrophages
CATTCTACACGGTAGA-1	T cells
CATTCTAGTAAGTAGT-1	T cells
CATTCTAGTTGTGCCG-1	B cells
CATTCTATCACCTACC-1	T cells
CATTGAGAGAAGCGCT-1	Epithelial cells
CATTGAGAGGCCGCTT-1	Epithelial cells
CATTGAGAGTGACCTT-1	pDC
CATTGAGAGTTGCGAG-1	T cells
CATTGAGCATCACCAA-1	T cells
CATTGAGCATCATCCC-1	Macrophages
CATTGAGCATTCGATG-1	Fibroblasts
CATTGAGCATTCTTCA-1	T cells
CATTGAGGTCAAGTTC-1	Epithelial cells
CATTGAGGTCGGCACT-1	Macrophages
CATTGCCAGACGCTCC-1	Macrophages
CATTGCCAGTTAGTGA-1	T cells
CATTGCCCAAGTCGTT-1	NK cells
CATTGCCCACGACTAT-1	T cells
CATTGCCCAGGCTTGC-1	T cells
CATTGCCGTAGCGATG-1	T cells
CATTGCCGTCACTTCC-1	T cells
CATTGCCTCATCGCAA-1	T cells
CATTGTTAGGGCCTCT-1	T cells
CATTGTTAGTTGTCGT-1	Epithelial cells
CATTGTTGTCGGAACA-1	T cells
CATTGTTTCACAGAGG-1	Epithelial cells
CATTGTTTCATGAGGG-1	Epithelial cells
CATTTCAAGCATCTTG-1	B cells
CATTTCACACACTGGC-1	Epithelial cells
CATTTCAGTCTGTCAA-1	Macrophages
CATTTCAGTGTCACAT-1	T cells
CATTTCAGTTTCAGAC-1	T cells
CATTTCATCATGAAAG-1	Epithelial cells
CCAAGCGAGCAGCCCT-1	Epithelial cells
CCAAGCGAGCCAGTAG-1	T cells
CCAAGCGCACGCTGTG-1	Epithelial cells
CCAAGCGCATGGGCAA-1	T cells
CCAAGCGGTCATTGCA-1	Macrophages
CCAAGCGGTGGCCACT-1	T cells
CCAAGCGTCAAGGTGG-1	T cells
CCAATGAAGATCCAAA-1	Epithelial cells
CCAATGAAGCCTTGAT-1	T cells
CCAATGACACAAGCTT-1	Epithelial cells
CCAATGACACCCTAGG-1	Epithelial cells
CCAATGACATTCCTCG-1	Fibroblasts
CCAATGAGTCTCTCCA-1	NK cells
CCAATTTAGATCCAAA-1	T cells
CCAATTTAGGTTTACC-1	Epithelial cells
CCAATTTGTGAGTGAC-1	T cells
CCAATTTGTTACCCTC-1	T cells
CCAATTTGTTACGCCG-1	T cells
CCAATTTTCAAGTTGC-1	Epithelial cells
CCACAAATCCTTCTGG-1	T cells
CCACAAATCTTACTGT-1	T cells
CCACACTCACTCCTGT-1	NK cells
CCACACTGTACTAACC-1	T cells
CCACACTGTATGCGTT-1	Epithelial cells
CCACACTGTGAATGTA-1	T cells
CCACACTTCAGGTAAA-1	T cells
CCACCATCACAAACGG-1	Epithelial cells
CCACCATCACGCAAAG-1	NK cells
CCACCATCACGGCACT-1	Epithelial cells
CCACCATCACGTCGGT-1	T cells
CCACCATCAGGCCCTA-1	T cells
CCACCATTCTATTTCG-1	T cells
CCACCATTCTCGCAGG-1	T cells
CCACGAGAGCTCACTA-1	T cells
CCACGAGAGTCATTGC-1	NK cells
CCACGAGCAAGACAAT-1	B cells
CCACGAGGTCACTCGG-1	Macrophages
CCACGAGTCTTGGCTC-1	Epithelial cells
CCACGTTAGGGTGAAA-1	Epithelial cells
CCACGTTGTTTGGAAA-1	T cells
CCACGTTTCCATCTAT-1	Epithelial cells
CCACGTTTCCCTTCCC-1	T cells
CCACGTTTCTCGCCTA-1	Fibroblasts
CCACTTGAGCAATTCC-1	T cells
CCACTTGAGCGACTTT-1	T cells
CCACTTGCAGAACTAA-1	Fibroblasts
CCACTTGTCCCAACTC-1	T cells
CCACTTGTCTGTCAGA-1	T cells
CCATAAGAGAACCGCA-1	Epithelial cells
CCATAAGCAAGATTGA-1	T cells
CCATAAGCAAGTCGTT-1	T cells
CCATAAGGTTCGGTCG-1	Epithelial cells
CCATAAGTCCGCTGTT-1	T cells
CCATAAGTCCTCTGCA-1	T cells
CCATCACCACTTTAGG-1	Fibroblasts
CCATCACCAGTTTCGA-1	Epithelial cells
CCATCACCATGTGCTA-1	T cells
CCATCACGTCGTGATT-1	DC
CCATCACTCCCGTTCA-1	T cells
CCATCACTCTGTGCAA-1	T cells
CCATCACTCTGTTCAT-1	Epithelial cells
CCCAACTAGCCGAACA-1	DC
CCCAACTCACTATCCC-1	T cells
CCCAACTTCTAGAGCT-1	B cells
CCCATTGAGCACTCCG-1	DC
CCCATTGAGTTGGGAC-1	NK cells
CCCATTGCACCAACAT-1	T cells
CCCATTGCACCCTTGT-1	T cells
CCCATTGCAGGTCCGT-1	Endothelial cells
CCCATTGGTCCTGTCT-1	T cells
CCCGAAGAGAGGCGTT-1	pDC
CCCGAAGAGGTCCTGC-1	T cells
CCCGAAGCAAGAGTAT-1	T cells
CCCGAAGCAAGAGTGC-1	T cells
CCCGAAGCACGTAGTT-1	T cells
CCCGAAGTCCGGACTG-1	T cells
CCCGGAAAGAAGTCCG-1	Monocytes
CCCGGAAAGTGGTCAG-1	Epithelial cells
CCCGGAAAGTGGTGAC-1	T cells
CCCGGAACATGACTCA-1	T cells
CCCGGAAGTATCGTTG-1	T cells
CCCGGAAGTTAGGGAC-1	Macrophages
CCCGGAATCAATCTCT-1	T cells
CCCGGAATCTCCGAAA-1	T cells
CCCTAACCAAAGACTA-1	T cells
CCCTAACGTCTGGTTA-1	T cells
CCCTAACTCTATCCAT-1	T cells
CCCTCAAAGAAGTCTA-1	T cells
CCCTCAAAGTGGTCAG-1	Macrophages
CCCTCAAGTGTCTAAC-1	Macrophages
CCCTCAAGTTTGGGAG-1	T cells
CCCTCTCAGACTAGAT-1	T cells
CCCTCTCAGTCAACAA-1	NK cells
CCCTCTCCAAAGCACG-1	B cells
CCCTCTCCAAGCCTGC-1	T cells
CCCTCTCCACGCCACA-1	Macrophages
CCCTCTCCACTCCGGA-1	NK cells
CCCTCTCTCCAACCAA-1	Epithelial cells
CCCTCTCTCCAGCTCT-1	Epithelial cells
CCCTCTCTCGGTAACT-1	T cells
CCCTGATAGGCGCTTC-1	Monocytes
CCCTGATAGTGATCGG-1	T cells
CCCTGATCAACCAATC-1	Monocytes
CCCTGATCAAGCTCTA-1	Epithelial cells
CCCTGATCAGTTGGTT-1	T cells
CCCTGATGTAAGGCCA-1	T cells
CCCTGATGTAGATTGA-1	B cells
CCCTGATGTCTACAAC-1	T cells
CCCTTAGCAACCGTAT-1	Epithelial cells
CCCTTAGCACGTCTCT-1	T cells
CCCTTAGGTTGCCAAT-1	T cells
CCCTTAGTCATTCGTT-1	T cells
CCCTTAGTCATTGTTC-1	T cells
CCCTTAGTCCGGTAAT-1	T cells
CCCTTAGTCGCTGCGA-1	T cells
CCGAACGAGGAGTCTG-1	NK cells
CCGAACGCACTCAGAT-1	T cells
CCGAACGCACTGGATT-1	T cells
CCGAACGGTTCGGCCA-1	Monocytes
CCGAACGTCGGTTAGT-1	Monocytes
CCGAACGTCTATCCAT-1	Epithelial cells
CCGAACGTCTTTCTAG-1	Macrophages
CCGATCTAGCCGATCC-1	B cells
CCGATCTAGCGACTGA-1	Epithelial cells
CCGATCTGTAACGATA-1	T cells
CCGATCTGTATGCTAC-1	NK cells
CCGATGGAGTCTGTAC-1	T cells
CCGATGGCAGATACTC-1	T cells
CCGATGGCAGGCTCTG-1	Fibroblasts
CCGATGGGTATTGCCA-1	T cells
CCGCAAGAGGACAGCT-1	T cells
CCGCAAGCAATGACCT-1	T cells
CCGCAAGCACTGGCCA-1	Epithelial cells
CCGCAAGGTCATATGC-1	Epithelial cells
CCGCAAGGTCTGCATA-1	NK cells
CCGGACACAACTACGT-1	T cells
CCGGACAGTCATAAAG-1	Epithelial cells
CCGGGTAAGTACGAGC-1	Epithelial cells
CCGGGTACAACAGCTT-1	Macrophages
CCGGGTACAAGTATCC-1	T cells
CCGGGTACACCTATCC-1	T cells
CCGGGTACAGCGAACA-1	B cells
CCGGTAGCAGAGGTTG-1	Macrophages
CCGGTAGCATCCGCGA-1	T cells
CCGGTAGGTCACTTAG-1	Fibroblasts
CCGGTAGGTTTCCATT-1	Macrophages
CCGGTAGTCGCAATTG-1	Epithelial cells
CCGGTGAAGTATTGCC-1	Epithelial cells
CCGGTGACACAGGATG-1	Macrophages
CCGGTGACAGGACAGT-1	T cells
CCGGTGATCAGTGTGT-1	T cells
CCGGTGATCGGTGTTA-1	Fibroblasts
CCGTAGGAGAGTCTTC-1	T cells
CCGTAGGAGTAGAGTT-1	Epithelial cells
CCGTAGGAGTCCCTAA-1	Macrophages
CCGTAGGCATGCCATA-1	DC
CCGTAGGGTACTAAGA-1	T cells
CCGTAGGGTGCATTTG-1	T cells
CCGTAGGGTGCCTGAC-1	T cells
CCGTAGGGTTGTAGCT-1	T cells
CCGTAGGTCAACTACG-1	T cells
CCGTAGGTCAGGAAAT-1	T cells
CCGTGAGCACCAAAGG-1	Macrophages
CCGTGAGCAGTGCGCT-1	T cells
CCGTTCAAGCCGATCC-1	T cells
CCGTTCACAACCACGC-1	T cells
CCGTTCACAAGAGATT-1	Epithelial cells
CCGTTCACAATACGAA-1	NK cells
CCGTTCACACCTCAGG-1	T cells
CCGTTCACAGCCGGTT-1	pDC
CCGTTCACAGGCTATT-1	Epithelial cells
CCGTTCACAGTCTTCC-1	Macrophages
CCGTTCAGTCCGATCG-1	T cells
CCGTTCAGTGTCCGGT-1	Macrophages
CCTAACCAGGTTGACG-1	T cells
CCTAACCAGTGGAAGA-1	T cells
CCTAACCCATGGCCCA-1	Epithelial cells
CCTAACCGTACGAGCA-1	Macrophages
CCTAACCGTATCGGTT-1	T cells
CCTAACCTCGTTGTAG-1	Macrophages
CCTAACCTCTTGGAAC-1	NK cells
CCTAAGAAGCACCTGC-1	T cells
CCTAAGAAGGGCAACT-1	T cells
CCTAAGACAATAGTAG-1	Epithelial cells
CCTAAGACACACAGAG-1	T cells
CCTAAGACAGTTTCAG-1	T cells
CCTAAGACATAAGATG-1	Macrophages
CCTAAGAGTACGCTAT-1	T cells
CCTAAGAGTGCGAGTA-1	Epithelial cells
CCTAAGATCCTCTCGA-1	T cells
CCTACGTAGATCCCGC-1	Fibroblasts
CCTACGTAGGCTAACG-1	Epithelial cells
CCTACGTAGGGCAATC-1	T cells
CCTACGTAGGTTACAA-1	T cells
CCTACGTAGTCACTCA-1	T cells
CCTACGTAGTCTGCAT-1	T cells
CCTACGTCAAAGCTAA-1	B cells
CCTACGTGTACCAATC-1	T cells
CCTACGTGTACTGAGG-1	NK cells
CCTACGTGTCGAACGA-1	T cells
CCTACGTGTCTGTTAG-1	T cells
CCTACGTGTTCCACGG-1	B cells
CCTACGTTCATGCCCT-1	T cells
CCTACGTTCCGTGTGG-1	T cells
CCTATCGAGCTGGAGT-1	T cells
CCTATCGGTCGAATGG-1	Macrophages
CCTATCGGTTCGTAAC-1	B cells
CCTATCGTCCCATTTA-1	Epithelial cells
CCTCAACAGACAACTA-1	Epithelial cells
CCTCAACAGACCAAAT-1	NK cells
CCTCAACAGCTGACTT-1	Epithelial cells
CCTCAACCAAGCCATT-1	T cells
CCTCAACCAAGGGCAT-1	Macrophages
CCTCAACCATAATCGC-1	T cells
CCTCAACGTCCTTAAG-1	NK cells
CCTCAACGTTTGGAGG-1	Epithelial cells
CCTCAACTCTCCAATT-1	T cells
CCTCAACTCTCTGACC-1	Epithelial cells
CCTCACACATGAGATA-1	T cells
CCTCACAGTTAGCGGA-1	T cells
CCTCACATCCTTATGT-1	T cells
CCTCAGTAGAGTCAAT-1	T cells
CCTCAGTAGGAAAGGT-1	T cells
CCTCAGTAGTCGCCAC-1	T cells
CCTCAGTCAGAGAAAG-1	Macrophages
CCTCAGTGTGATTCAC-1	T cells
CCTCAGTGTGGCTTAT-1	T cells
CCTCAGTTCTGTCCCA-1	T cells
CCTCATGCACCTTCCA-1	T cells
CCTCATGCAGGCATGA-1	Epithelial cells
CCTCATGGTTGCAAGG-1	DC
CCTCCAAAGACTTCGT-1	T cells
CCTCCAACACAGCTGC-1	Macrophages
CCTCCAAGTAAGTTGA-1	T cells
CCTCCAAGTACGACAG-1	Monocytes
CCTCCAAGTGAATATG-1	B cells
CCTCCAATCCATCTGC-1	T cells
CCTCCTCAGGTTTACC-1	T cells
CCTCCTCAGTCGAATA-1	T cells
CCTCCTCGTAGATTAG-1	T cells
CCTCCTCGTTAGAAAC-1	T cells
CCTCCTCTCCCTTGGT-1	T cells
CCTCCTCTCCGGCTTT-1	NK cells
CCTCTAGAGGCGTTAG-1	T cells
CCTCTAGCAAGGCTTT-1	T cells
CCTCTAGCATCAGTGT-1	T cells
CCTCTAGTCAAATGCC-1	T cells
CCTCTAGTCCATTCAT-1	B cells
CCTCTCCCAGCGTACC-1	T cells
CCTCTCCCATTGGATC-1	T cells
CCTCTCCGTACCCGCA-1	T cells
CCTCTCCGTCACGCTG-1	Epithelial cells
CCTCTCCGTGAGATCG-1	T cells
CCTCTCCGTTTCTATC-1	T cells
CCTCTCCTCCCTCATG-1	T cells
CCTGCATAGCCTCTCT-1	T cells
CCTGCATCAGGAGACT-1	Epithelial cells
CCTGCATGTAGCACAG-1	Epithelial cells
CCTGTTGAGTGAATAC-1	T cells
CCTGTTGCAGCTGTCG-1	T cells
CCTGTTGGTAGTCCTA-1	T cells
CCTGTTGGTATACGGG-1	T cells
CCTGTTGGTGCGCTCA-1	T cells
CCTTCAGAGCAATAGT-1	Macrophages
CCTTCAGAGCGATGAC-1	T cells
CCTTCAGCACCAATTG-1	T cells
CCTTCAGGTAACCCGC-1	Macrophages
CCTTCAGGTGATTCAC-1	Epithelial cells
CCTTGTGCATCTAACG-1	T cells
CCTTGTGCATGACTTG-1	T cells
CCTTGTGTCACTGAAC-1	T cells
CCTTGTGTCCGATCTC-1	NK cells
CCTTTGGCACTGTTCC-1	T cells
CCTTTGGGTCACTCGG-1	NK cells
CCTTTGGGTCGTTGCG-1	T cells
CGAAGGAAGTCTAGAA-1	Epithelial cells
CGAAGGACAGCTGAAG-1	Macrophages
CGAAGGAGTAGACGGT-1	Macrophages
CGAAGTTCATCCGAAT-1	Epithelial cells
CGAAGTTTCCCTCAAC-1	T cells
CGAAGTTTCTCTCCGA-1	T cells
CGAATTGCAACAGATA-1	Epithelial cells
CGAATTGCAGACGGAT-1	T cells
CGAATTGCAGTAACCT-1	T cells
CGAATTGGTAAGCAAT-1	Fibroblasts
CGAATTGGTCATGCAT-1	Macrophages
CGAATTGTCCCAATAG-1	DC
CGACAGCCACAGCTTA-1	DC
CGACAGCCATCTAACG-1	T cells
CGACAGCGTTAGGACG-1	T cells
CGACAGCGTTCCCAAA-1	T cells
CGACAGCTCGATTCCC-1	T cells
CGAGAAGCATCGAGCC-1	B cells
CGAGAAGCATCTATCT-1	T cells
CGAGAAGGTTCTCTCG-1	Monocytes
CGAGAAGTCATCACAG-1	T cells
CGAGGAAAGTGTACCT-1	DC
CGAGGAACATGCGGTC-1	T cells
CGAGGAATCCATCGTC-1	T cells
CGAGGAATCTCTTAAC-1	Epithelial cells
CGAGGCTAGATCACTC-1	T cells
CGAGGCTCACAACGCC-1	Macrophages
CGAGGCTCACACACGC-1	T cells
CGAGGCTTCCTGCTAC-1	T cells
CGAGGCTTCGATACAC-1	Epithelial cells
CGAGGCTTCTTCGTGC-1	T cells
CGAGTGCAGAATCGAT-1	T cells
CGAGTGCAGCGCCTTG-1	T cells
CGAGTGCAGGGTCAAC-1	T cells
CGAGTGCCAGTTAGGG-1	T cells
CGAGTGCCATCACCAA-1	Macrophages
CGAGTGCTCTATTGTC-1	Fibroblasts
CGAGTTAAGCAGTACG-1	T cells
CGAGTTAGTACCATAC-1	T cells
CGAGTTAGTACCGGCT-1	Epithelial cells
CGAGTTATCAAACTGC-1	Epithelial cells
CGAGTTATCACTCTTA-1	Epithelial cells
CGAGTTATCCTCACCA-1	T cells
CGAGTTATCTAAGCGT-1	Macrophages
CGATCGGAGATAACGT-1	pDC
CGATCGGAGGCACAAC-1	T cells
CGATCGGAGGGTACAC-1	Monocytes
CGATCGGCAAGCACAG-1	Epithelial cells
CGATCGGGTCGCTGCA-1	T cells
CGATGCGAGGCCTAGA-1	T cells
CGATGCGCATCTTAGG-1	NK cells
CGATGCGCATGTGACT-1	Plasma cells
CGATGCGGTTTAGACC-1	T cells
CGATGGCAGGAGAGTA-1	NK cells
CGATGGCAGGTACAAT-1	T cells
CGATGGCAGTCGGGAT-1	T cells
CGATGGCCACAATTCG-1	Macrophages
CGATGGCCACAGCTTA-1	T cells
CGATGGCCACCAGACC-1	T cells
CGATGGCCAGACGATG-1	Epithelial cells
CGATGGCCAGTTTGGT-1	T cells
CGATGGCGTACGTGTT-1	Endothelial cells
CGATGGCGTGACAACG-1	T cells
CGATGGCTCAGACCTA-1	NK cells
CGATGGCTCCGCACGA-1	Epithelial cells
CGATGGCTCTATCGTT-1	T cells
CGCAGGTAGACTACCT-1	Epithelial cells
CGCAGGTAGGAAAGGT-1	Epithelial cells
CGCAGGTGTAGTCTTG-1	T cells
CGCAGGTGTGGTTTGT-1	Fibroblasts
CGCAGGTTCGCCGATG-1	Fibroblasts
CGCATAAAGGCCTGCT-1	T cells
CGCATAAAGTATGAAC-1	B cells
CGCATAACAACCACAT-1	T cells
CGCATAACATTGCCTC-1	T cells
CGCATGGAGCCATATC-1	T cells
CGCATGGAGCTGGCCT-1	T cells
CGCATGGCATCCGAGC-1	T cells
CGCATGGGTCGTTGGC-1	Fibroblasts
CGCATGGTCTATCCAT-1	pDC
CGCCAGAAGGCATTTC-1	Macrophages
CGCCAGAGTCGCGTCA-1	T cells
CGCCAGAGTTACGCCG-1	Epithelial cells
CGCCATTAGCTCGCAC-1	NK cells
CGCCATTAGGACATCG-1	T cells
CGCCATTCACTATCGA-1	T cells
CGCCATTCAGAGATTA-1	T cells
CGCCATTGTAACCCGC-1	T cells
CGCCATTGTACTGAGG-1	Fibroblasts
CGCCATTGTAGCACAG-1	DC
CGCCATTGTGTAACGG-1	B cells
CGCGTGAAGTCACACT-1	Epithelial cells
CGCGTGACAATCACGT-1	T cells
CGCGTGAGTGTGTGGA-1	T cells
CGCGTGATCGATGCAT-1	Epithelial cells
CGGAACCCACAAATCC-1	T cells
CGGAACCCAGTTAAAG-1	Endothelial cells
CGGAACCTCTGGTGCG-1	Monocytes
CGGAATTAGCTACGTT-1	DC
CGGAATTAGGTACCTT-1	T cells
CGGAATTCAAGTCATC-1	T cells
CGGAATTCACCAATTG-1	Macrophages
CGGAATTTCCACGAAT-1	T cells
CGGAATTTCTCCAATT-1	T cells
CGGACACAGGCAGTCA-1	T cells
CGGACACAGTAAGGGA-1	T cells
CGGACACCAACCTAAC-1	T cells
CGGACACGTCCTCAGG-1	Epithelial cells
CGGACACTCCACCCTA-1	Monocytes
CGGACACTCCCAGGCA-1	Fibroblasts
CGGAGAAAGCGTATAA-1	pDC
CGGAGAAAGGGACCAT-1	Epithelial cells
CGGAGAATCTGCTGAA-1	T cells
CGGCAGTAGTAGAGTT-1	Monocytes
CGGCAGTCACGACGAA-1	Epithelial cells
CGGCAGTCAGGTCTCG-1	T cells
CGGCAGTCATCATCTT-1	Fibroblasts
CGGCAGTGTCACAGTT-1	DC
CGGCAGTTCAACACGT-1	Epithelial cells
CGGGACTCACGGCACT-1	B cells
CGGGACTCATCGAACT-1	T cells
CGGGACTGTCAGTCCG-1	T cells
CGGGACTGTTGAGGAC-1	T cells
CGGGACTTCGGTGTTA-1	T cells
CGGGCATAGATGGTCG-1	T cells
CGGGCATTCGTAGCCG-1	Fibroblasts
CGGGCATTCTGGAAGG-1	Endothelial cells
CGGGTCAAGTGCTCAT-1	Epithelial cells
CGGGTCAGTTATAGCC-1	T cells
CGGGTCAGTTCGCGTG-1	Fibroblasts
CGGGTCAGTTTCCAAG-1	T cells
CGGGTCATCCGCATAA-1	T cells
CGGGTGTAGGGATCGT-1	Macrophages
CGGGTGTCAGACACAG-1	T cells
CGGGTGTGTCACATTG-1	T cells
CGGGTGTGTCCAGCCA-1	Fibroblasts
CGGGTGTTCAATCTCT-1	DC
CGGGTGTTCCGCGATG-1	Macrophages
CGGGTGTTCTGTGCGG-1	T cells
CGGTCAGAGAGATTCA-1	T cells
CGGTCAGAGGCACTCC-1	B cells
CGGTCAGGTGCCTAAT-1	T cells
CGGTCAGTCTCAGGCG-1	T cells
CGGTCAGTCTTACGGA-1	T cells
CGTAAGTAGCTGTCCG-1	T cells
CGTAAGTGTGAGCGAT-1	NK cells
CGTAAGTGTGGCATCC-1	Monocytes
CGTAAGTGTTAAAGTG-1	Epithelial cells
CGTAAGTTCCCTCAAC-1	NK cells
CGTAAGTTCCGCCTAT-1	DC
CGTAAGTTCGAAGTGG-1	T cells
CGTAAGTTCTCTCAAT-1	Epithelial cells
CGTAATGAGTAGAGTT-1	Epithelial cells
CGTAATGCAATAGTCC-1	T cells
CGTAATGTCAGGACGA-1	T cells
CGTAATGTCCACGGAC-1	B cells
CGTAATGTCGATTGGT-1	Monocytes
CGTAGTAAGGGCGAAG-1	Epithelial cells
CGTAGTAAGGTTATAG-1	Epithelial cells
CGTAGTACACCCTGAG-1	pDC
CGTAGTACAGAGCCCT-1	Monocytes
CGTAGTACAGCTGTGC-1	T cells
CGTAGTAGTAGAATAC-1	T cells
CGTAGTAGTGTCTTCC-1	Epithelial cells
CGTAGTATCCACTTCG-1	T cells
CGTCAAAGTACTGAGG-1	T cells
CGTCCATAGCCTATTG-1	T cells
CGTCCATAGGCGAAGG-1	DC
CGTCCATAGTATGATG-1	T cells
CGTCCATCACCAATTG-1	Epithelial cells
CGTCCATCACCTCGTT-1	Epithelial cells
CGTCCATCAGAGTGTG-1	T cells
CGTCCATGTGACAACG-1	T cells
CGTCCATTCACGGTCG-1	T cells
CGTCCATTCCTCACTG-1	DC
CGTGAATGTTGCCATA-1	T cells
CGTGAATTCCGATGTA-1	B cells
CGTGAATTCGATTCCC-1	T cells
CGTGATAGTCGAGCTC-1	Fibroblasts
CGTGATAGTGTAGGAC-1	Epithelial cells
CGTGATATCTGCGGAC-1	DC
CGTGCTTCACACGGAA-1	T cells
CGTGCTTGTTCGTTCC-1	B cells
CGTGCTTTCTATACTC-1	Epithelial cells
CGTGTCTAGGGAGGAC-1	T cells
CGTGTCTGTTACACAC-1	T cells
CGTGTCTTCGCTGCGA-1	Endothelial cells
CGTGTCTTCTCGCGTT-1	T cells
CGTTAGACAAACCACT-1	T cells
CGTTAGACACTGAATC-1	T cells
CGTTAGACACTGTGTA-1	T cells
CGTTAGACAGACCATT-1	T cells
CGTTAGACAGCTGCCA-1	T cells
CGTTAGAGTTCGGGTC-1	T cells
CGTTAGATCCGTAGGC-1	T cells
CGTTAGATCTCAACGA-1	NK cells
CGTTAGATCTGAGTCA-1	T cells
CGTTCTGAGTCGCCAC-1	NK cells
CGTTCTGAGTGGACTG-1	Monocytes
CGTTCTGGTGAGCTCC-1	T cells
CGTTGGGAGCCTCAGC-1	T cells
CGTTGGGCAGTGTATC-1	Epithelial cells
CGTTGGGGTCTTTCTA-1	DC
CGTTGGGGTGGTACAG-1	Epithelial cells
CGTTGGGTCAGTCTTT-1	T cells
CGTTGGGTCGCCAACG-1	T cells
CTAACCCCAGTGAGCA-1	T cells
CTAACCCCATTCTGTT-1	pDC
CTAACCCTCCCACAGG-1	T cells
CTAACTTAGATCCAAA-1	Epithelial cells
CTAACTTAGTATTAGG-1	T cells
CTAACTTCAGGTTTAC-1	Epithelial cells
CTAACTTGTCCTGAAT-1	Epithelial cells
CTAACTTTCAACTGAC-1	Plasma cells
CTAAGTGAGGTACCTT-1	NK cells
CTAAGTGAGTAGCTCT-1	T cells
CTAAGTGCAACTCGTA-1	B cells
CTAAGTGCAGCCATTA-1	Monocytes
CTAAGTGCAGCTCGGT-1	T cells
CTAAGTGGTGTCTTAG-1	Epithelial cells
CTAAGTGGTTGGGATG-1	Epithelial cells
CTACAGAAGCAGGGAG-1	Macrophages
CTACAGAAGGCCTTGC-1	T cells
CTACAGAAGGGTTAAT-1	B cells
CTACAGAGTAGAGACC-1	T cells
CTACAGAGTAGTCGTT-1	T cells
CTACAGAGTCCAGAAG-1	Epithelial cells
CTACATTAGAGTTGAT-1	Epithelial cells
CTACATTAGATTACCC-1	Macrophages
CTACATTAGGTGGCTA-1	T cells
CTACATTCAGTTTCGA-1	T cells
CTACATTGTATCGAAA-1	T cells
CTACATTGTGCTGCAC-1	T cells
CTACATTGTGTATTCG-1	B cells
CTACATTTCATTTGTC-1	DC
CTACCCACACAGCTTA-1	T cells
CTACCCACACGGAAGT-1	Macrophages
CTACCCAGTAATCAGA-1	T cells
CTACCCAGTCCGCAGT-1	T cells
CTACCCAGTCTGTCCT-1	DC
CTACCCAGTGTCTTCC-1	T cells
CTACCTGAGACATACA-1	B cells
CTACCTGAGGGTAATT-1	Macrophages
CTACCTGGTAAGACCG-1	Epithelial cells
CTACCTGGTAGAATGT-1	Epithelial cells
CTACCTGGTGTTGAGG-1	B cells
CTACCTGTCCCAATAG-1	Macrophages
CTACCTGTCCTTATAC-1	T cells
CTACGGGAGGTAAGGA-1	Fibroblasts
CTACGGGCAACCCGCA-1	Epithelial cells
CTACGGGCACTACAGT-1	Epithelial cells
CTACGGGCATCGTCCT-1	T cells
CTACGGGGTCCTGTCT-1	T cells
CTACGGGGTCTCACGG-1	T cells
CTACGGGTCGTTCCCA-1	T cells
CTACTATAGCTAAGTA-1	pDC
CTACTATAGGCCACCT-1	Epithelial cells
CTACTATAGGTGGCTA-1	NK cells
CTACTATCAAGATTGA-1	T cells
CTACTATGTCTTGAGT-1	B cells
CTACTATGTGCATTAC-1	T cells
CTACTATGTGTTACAC-1	B cells
CTACTATTCATAGGCT-1	T cells
CTACTATTCCACCTGT-1	Epithelial cells
CTAGACAAGCCATTGT-1	T cells
CTAGACAAGCGGTAGT-1	Macrophages
CTAGACAAGTCCTGCG-1	Epithelial cells
CTAGACATCATGGAGG-1	T cells
CTAGGTACACAGTGTT-1	T cells
CTAGGTACATTGTACG-1	Monocytes
CTAGGTATCAATGTCG-1	Epithelial cells
CTATAGGAGAAGTATC-1	T cells
CTATAGGCAGTTAGGG-1	T cells
CTATAGGTCCGAAGGA-1	Epithelial cells
CTATAGGTCTCATTGT-1	T cells
CTATAGGTCTGCCTGT-1	T cells
CTATCCGAGAGCCGTA-1	Monocytes
CTATCCGCATGCCGGT-1	Epithelial cells
CTATCCGGTGAGGATC-1	T cells
CTATCCGTCCCTATTA-1	T cells
CTATCTAAGGACAGCT-1	Epithelial cells
CTATCTAGTAGGAAAG-1	T cells
CTATCTAGTGATTGGG-1	Epithelial cells
CTATCTAGTTAGAAGT-1	Macrophages
CTCAACCAGAGCATAT-1	Epithelial cells
CTCAACCAGTGGAATT-1	Epithelial cells
CTCAACCCACTGGCCA-1	T cells
CTCAACCGTGTTTACG-1	DC
CTCAACCTCTCTAAGG-1	Epithelial cells
CTCAAGACAACCCTAA-1	NK cells
CTCAAGACATCCGCGA-1	DC
CTCAAGAGTTCACGAT-1	Epithelial cells
CTCAAGATCGGCCTTT-1	Epithelial cells
CTCAATTAGCACTGGA-1	T cells
CTCAATTGTACCTAGT-1	T cells
CTCAATTGTGACAACG-1	T cells
CTCACTGCAGCACGAA-1	T cells
CTCACTGGTATGAGAT-1	NK cells
CTCACTGGTCGCGTCA-1	T cells
CTCACTGGTTACACAC-1	Epithelial cells
CTCAGAACATTGGATC-1	T cells
CTCAGAAGTAGGAGGG-1	Epithelial cells
CTCAGAAGTCAGACTT-1	B cells
CTCAGAAGTGTCATTG-1	Epithelial cells
CTCAGGGAGCCTTGAT-1	Monocytes
CTCAGGGCATGATCTG-1	Epithelial cells
CTCAGGGGTACTCCGG-1	T cells
CTCAGGGGTCGTTCAA-1	T cells
CTCAGGGGTGATTCTG-1	T cells
CTCAGGGTCCAACTGA-1	T cells
CTCAGTCAGTTTGCTG-1	T cells
CTCAGTCGTAGCTGTT-1	Fibroblasts
CTCAGTCGTTACCCTC-1	Epithelial cells
CTCAGTCTCTCAACCC-1	B cells
CTCATCGAGCGCCATC-1	Monocytes
CTCATCGAGGGCAGTT-1	pDC
CTCATCGCAGCTCGGT-1	Macrophages
CTCATCGCATCGATAC-1	T cells
CTCATGCAGAGGGTCT-1	Epithelial cells
CTCATGCAGCATTTGC-1	Fibroblasts
CTCATGCAGTCCCAAT-1	T cells
CTCATGCCACAATTCG-1	Epithelial cells
CTCATGCGTTCATCGA-1	Monocytes
CTCATGCTCAAGTTGC-1	Macrophages
CTCATTACAAGTGCAG-1	Macrophages
CTCATTACATATTCGG-1	T cells
CTCATTAGTACAAGTA-1	T cells
CTCATTAGTCCACTTC-1	Endothelial cells
CTCATTATCATTGCGA-1	T cells
CTCATTATCCCAGCGA-1	T cells
CTCATTATCTAAACGC-1	T cells
CTCATTATCTACCCAC-1	Epithelial cells
CTCCAACAGTAACAGT-1	T cells
CTCCAACCAGAACCGA-1	Epithelial cells
CTCCAACCAGCCTTCT-1	NK cells
CTCCAACGTGCCTTCT-1	T cells
CTCCAACTCCGTGTGG-1	T cells
CTCCAACTCTACTGAG-1	T cells
CTCCACAAGGATATAC-1	Monocytes
CTCCACACACGCGCAT-1	Macrophages
CTCCACACATCCTGTC-1	Epithelial cells
CTCCACATCTGGCCAG-1	Macrophages
CTCCATGCAGGTCCCA-1	T cells
CTCCATGGTGGTAATA-1	T cells
CTCCATGTCCGATAGT-1	T cells
CTCCCAAAGAGGCGGA-1	NK cells
CTCCCAACAACAAGTA-1	NK cells
CTCCCAACACACACTA-1	T cells
CTCCCAACACTCGATA-1	T cells
CTCCCAACAGTGGCTC-1	T cells
CTCCCAAGTAGCACGA-1	Epithelial cells
CTCCCAATCGAGAAAT-1	T cells
CTCCCTCAGCACCGTC-1	Plasma cells
CTCCCTCAGCCTATCA-1	T cells
CTCCGATAGACGGATC-1	T cells
CTCCGATAGACTAAGT-1	B cells
CTCCGATAGCCGCTTG-1	T cells
CTCCGATCACACGGTC-1	Monocytes
CTCCGATCACGTAACT-1	T cells
CTCCGATGTATCCTCC-1	NK cells
CTCCGATGTATGCGGA-1	T cells
CTCCGATGTCGACGCT-1	Plasma cells
CTCCGATGTTCGGTCG-1	Epithelial cells
CTCCGATTCATTACGG-1	NK cells
CTCCGATTCCATAGGT-1	Epithelial cells
CTCCTCCAGCCTTTCC-1	B cells
CTCCTCCAGGTTTACC-1	Epithelial cells
CTCCTCCAGTGTACCT-1	T cells
CTCCTCCCACCCTTGT-1	T cells
CTCCTCCCAGGACTAG-1	T cells
CTCCTCCCATCCGAAT-1	T cells
CTCCTCCCATTGTGCA-1	T cells
CTCCTCCGTAGAGATT-1	T cells
CTCCTCCGTATTTCGG-1	T cells
CTCCTCCGTGGTTTAC-1	T cells
CTCCTCCTCGAACGCC-1	T cells
CTCCTCCTCGCCGAAC-1	T cells
CTCCTCCTCTAATTCC-1	T cells
CTCCTCCTCTGTCAGA-1	T cells
CTCCTTTAGACCAAGC-1	Fibroblasts
CTCCTTTAGTCCTGCG-1	T cells
CTCCTTTCATAGTCGT-1	Macrophages
CTCCTTTCATGTCGTA-1	Macrophages
CTCCTTTGTCTTTATC-1	Epithelial cells
CTCCTTTTCAGAACCT-1	DC
CTCCTTTTCGGCGATC-1	Monocytes
CTCCTTTTCGGCTTGG-1	Epithelial cells
CTCCTTTTCTCATGCC-1	T cells
CTCCTTTTCTTCGATT-1	T cells
CTCGAGGAGATACCAA-1	Macrophages
CTCGAGGAGGTCCCTG-1	Epithelial cells
CTCGAGGAGTACAGAT-1	T cells
CTCGAGGAGTTAGTAG-1	pDC
CTCGAGGCAAAGCAAT-1	T cells
CTCGAGGCAAATGCGG-1	T cells
CTCGAGGCAAGCCCAC-1	Macrophages
CTCGAGGCAGAAGTGC-1	T cells
CTCGAGGTCCATCTGC-1	Epithelial cells
CTCTCAGAGGGCGAAG-1	T cells
CTCTCAGCACCACATA-1	Macrophages
CTCTCAGGTAAGCTCT-1	Macrophages
CTCTCAGGTGTTAAAG-1	NK cells
CTCTCAGGTTCGTAAC-1	Plasma cells
CTCTCAGGTTGGAGAC-1	Plasma cells
CTCTCAGTCTATCGTT-1	Macrophages
CTCTCGAAGGTTTGAA-1	Epithelial cells
CTCTCGACAAGTGGGT-1	Endothelial cells
CTCTCGACATAATGCC-1	DC
CTCTCGAGTCTCACGG-1	T cells
CTCTCGAGTGTCTTAG-1	Epithelial cells
CTCTCGATCCTACGAA-1	T cells
CTCTCGATCTCCGCAT-1	Macrophages
CTCTGGTAGGCGAACT-1	Monocytes
CTCTGGTAGTATGACA-1	T cells
CTCTGGTCACGGTAGA-1	T cells
CTCTGGTCAGCGGTTC-1	DC
CTCTGGTCAGCTCGGT-1	Monocytes
CTCTGGTCATCGTCCT-1	Fibroblasts
CTCTGGTTCGTACACA-1	B cells
CTGAATGCACACCAGC-1	Epithelial cells
CTGAATGGTCCTCCAT-1	T cells
CTGAATGGTTGAGAGC-1	pDC
CTGAATGGTTGTGCCG-1	Monocytes
CTGAGCGCAAGCCATT-1	NK cells
CTGAGCGGTTGATCGT-1	T cells
CTGAGCGGTTTCGTTT-1	T cells
CTGAGCGTCTTCCACG-1	T cells
CTGAGGCAGAAGCCTG-1	Epithelial cells
CTGAGGCCAAATGATG-1	T cells
CTGAGGCCATCATCTT-1	Macrophages
CTGAGGCCATCTGCGG-1	T cells
CTGAGGCGTATCGTAC-1	T cells
CTGAGGCGTGTCTCCT-1	Epithelial cells
CTGAGGCGTTAAAGTG-1	T cells
CTGAGGCTCTCGCAGG-1	T cells
CTGATCCAGAGTCAAT-1	Epithelial cells
CTGATCCAGCAGTAAT-1	T cells
CTGATCCCAAACTCGT-1	NK cells
CTGATCCCAAGGCGTA-1	pDC
CTGATCCCAGGTGTGA-1	Epithelial cells
CTGATCCCAGTTACCA-1	T cells
CTGATCCGTGTCCCTT-1	T cells
CTGATCCTCATTGCGA-1	T cells
CTGCAGGAGCAATTAG-1	T cells
CTGCAGGGTAATGCGG-1	T cells
CTGCAGGGTGCCCTTT-1	T cells
CTGCAGGTCATCTATC-1	T cells
CTGCAGGTCCATCGTC-1	Macrophages
CTGCAGGTCGCCAGTG-1	T cells
CTGCAGGTCTACTATC-1	T cells
CTGCATCAGAATCGTA-1	T cells
CTGCATCAGATGTTAG-1	B cells
CTGCATCAGCAGGCAT-1	pDC
CTGCATCCACAGCTTA-1	Epithelial cells
CTGCATCGTATCACCA-1	pDC
CTGCATCGTCCTTTGC-1	Epithelial cells
CTGCATCGTTCCGCAG-1	T cells
CTGCATCTCTCTCTAA-1	T cells
CTGCCATAGAATCCCT-1	T cells
CTGCCATAGCAGGCAT-1	Epithelial cells
CTGCCATAGTTCATGC-1	Epithelial cells
CTGCCATGTCGTAATC-1	Endothelial cells
CTGCCTAAGAAGCTCG-1	T cells
CTGCCTAAGGGATCAC-1	T cells
CTGCCTACAGTAGAGC-1	Epithelial cells
CTGCCTACATCTAACG-1	T cells
CTGCCTATCGAGTACT-1	Epithelial cells
CTGCGAGAGAGGTATT-1	T cells
CTGCGAGAGCACCGTC-1	T cells
CTGCGAGCAATACGAA-1	Epithelial cells
CTGCGAGCATTATGCG-1	T cells
CTGCGAGTCGTAGTGT-1	T cells
CTGCTCAGTTCCCAAA-1	T cells
CTGGACGAGCGATGCA-1	Epithelial cells
CTGGACGCATCGAAGG-1	Plasma cells
CTGGACGTCTCGGTAA-1	T cells
CTGGCAGAGACATGCG-1	Epithelial cells
CTGGCAGAGAGGTGCT-1	T cells
CTGGCAGAGCAATAGT-1	T cells
CTGGCAGAGGCTAACG-1	Macrophages
CTGGCAGCACGTAGAG-1	Macrophages
CTGGCAGGTCTGTGTA-1	T cells
CTGGCAGGTTGGGACA-1	T cells
CTGGCAGTCGATTGAC-1	T cells
CTGGTCTAGCCGATAG-1	T cells
CTGGTCTAGCTGCCTG-1	T cells
CTGGTCTCAGTTACCA-1	T cells
CTGGTCTCATTCAGCA-1	T cells
CTGGTCTGTCACGACC-1	Monocytes
CTGGTCTTCAGAACCT-1	Macrophages
CTGGTCTTCGCCTATC-1	T cells
CTGTACCAGTCGCCCA-1	pDC
CTGTACCGTAATACCC-1	T cells
CTGTACCGTACCGGAA-1	T cells
CTGTACCTCGATCCAA-1	NK cells
CTGTACCTCTCCCATG-1	Epithelial cells
CTGTACCTCTTCCAGC-1	T cells
CTGTAGACAGGTTTAC-1	T cells
CTGTAGACATGGCTAT-1	T cells
CTGTAGACATTGTGCA-1	pDC
CTGTAGAGTTGCATGT-1	T cells
CTGTAGATCAACCTTT-1	T cells
CTGTAGATCGAGTGAG-1	NK cells
CTGTATTAGCCATCCG-1	B cells
CTGTATTAGTCTGCAT-1	Macrophages
CTGTATTCAGCACGAA-1	Epithelial cells
CTGTATTGTCTCACGG-1	pDC
CTGTATTTCTACCTTA-1	B cells
CTGTCGTAGAAATTGC-1	Epithelial cells
CTGTCGTAGCAACTTC-1	T cells
CTGTCGTAGCTTACGT-1	B cells
CTGTCGTAGTGGCCTC-1	T cells
CTGTCGTCAATGCTCA-1	T cells
CTGTCGTCAGCCTACG-1	Macrophages
CTGTCGTGTGTCCAAT-1	Epithelial cells
CTGTCGTTCATGTCTT-1	Monocytes
CTGTGAAAGTGATTCC-1	T cells
CTGTGAACAGAACCGA-1	T cells
CTGTGAACAGCAGATG-1	B cells
CTGTGAAGTGAAAGTT-1	Epithelial cells
CTGTGAAGTGATTCAC-1	Epithelial cells
CTGTGAATCAGCTGTA-1	Fibroblasts
CTGTGAATCTAGGAAA-1	Macrophages
CTGTGAATCTTCCAGC-1	Epithelial cells
CTGTGGGAGAGCAGAA-1	Macrophages
CTGTGGGCAACTCGAT-1	Epithelial cells
CTGTGGGGTAGATTAG-1	T cells
CTGTGGGTCGTAACCA-1	T cells
CTTACCGAGCTAGAGC-1	B cells
CTTACCGAGTAAATGC-1	T cells
CTTACCGAGTTCAACC-1	NK cells
CTTACCGCACGCTGAC-1	DC
CTTACCGCACTAGTAC-1	Epithelial cells
CTTACCGTCTGTGCGG-1	NK cells
CTTAGGAAGCGACTGA-1	DC
CTTAGGACAGAGGGTT-1	Monocytes
CTTAGGAGTAACCAGG-1	Macrophages
CTTAGGATCCGAGCTG-1	Epithelial cells
CTTCAATCAAGTCATC-1	T cells
CTTCAATCAGTGTACT-1	Epithelial cells
CTTCAATGTAGACAGC-1	Monocytes
CTTCCGAAGTGGTTCT-1	B cells
CTTCCGATCCGACAGC-1	T cells
CTTCCTTAGATGGCGT-1	T cells
CTTCCTTAGGAGACCT-1	DC
CTTCCTTAGTAGGAAG-1	Epithelial cells
CTTCCTTCAAACCATC-1	Epithelial cells
CTTCCTTCAATACCTG-1	T cells
CTTCCTTCAGCACCCA-1	T cells
CTTCCTTCATCGATCA-1	T cells
CTTCCTTCATCGCCTT-1	NK cells
CTTCCTTCATGACACT-1	T cells
CTTCCTTGTTACCGTA-1	Epithelial cells
CTTCCTTGTTCTCGCT-1	Epithelial cells
CTTCCTTTCCCGAACG-1	Epithelial cells
CTTCCTTTCCGGTTCT-1	DC
CTTCGGTAGATACTGA-1	Epithelial cells
CTTCGGTAGTAGTCTC-1	Epithelial cells
CTTCGGTCATGACAGG-1	T cells
CTTCGGTGTACCGGCT-1	Epithelial cells
CTTCGGTGTATCGCAT-1	T cells
CTTCGGTTCAAGTTGC-1	T cells
CTTCGGTTCTTAAGGC-1	T cells
CTTCTAACATGCGTGC-1	Epithelial cells
CTTCTAAGTCCAACGC-1	Epithelial cells
CTTCTAAGTCTGCATA-1	T cells
CTTCTAAGTTGCCTAA-1	Fibroblasts
CTTCTAATCCTGGCTT-1	T cells
CTTCTAATCTGGGCGT-1	Epithelial cells
CTTCTCTAGTCTAGCT-1	T cells
CTTCTCTCAAGGCTTT-1	T cells
CTTCTCTCACTGCATA-1	T cells
CTTCTCTGTTAAACCC-1	T cells
CTTGAGAAGGGTCACA-1	T cells
CTTGAGACACCCTGTT-1	T cells
CTTGAGACAGTCCGTG-1	T cells
CTTGAGATCGCTGCGA-1	Macrophages
CTTGATTAGCATCAAA-1	Macrophages
CTTGATTAGTATCCTG-1	NK cells
CTTGATTAGTGGTCAG-1	T cells
CTTGATTCAACCACGC-1	Fibroblasts
CTTGATTCACAGAAGC-1	T cells
CTTGATTCAGCGTGCT-1	T cells
CTTGATTGTAAGGAGA-1	T cells
CTTGATTGTAGATTGA-1	NK cells
CTTGATTTCCACCCTA-1	T cells
CTTGATTTCGGACCAC-1	Epithelial cells
CTTGATTTCGGTAAGG-1	B cells
CTTGATTTCTGAGGCC-1	Macrophages
CTTGATTTCTGAGGTT-1	T cells
CTTTCAAGTCCAGGTC-1	Plasma cells
CTTTCAATCAAAGGAT-1	Macrophages
CTTTCGGAGATCCAAA-1	Epithelial cells
CTTTCGGCAGCACCCA-1	T cells
CTTTCGGTCAGCTTCC-1	T cells
CTTTCGGTCATTGAGC-1	Fibroblasts
CTTTCGGTCTCAACGA-1	T cells
GAAACCTAGTAACGAT-1	T cells
GAAACCTCACTCAAGT-1	T cells
GAAACCTGTCGAAGCA-1	B cells
GAAACCTGTGCCGGTT-1	T cells
GAAACCTGTGGACTAG-1	B cells
GAAACCTTCAAGTTGC-1	Epithelial cells
GAAACCTTCAGACCGC-1	T cells
GAAACCTTCGAACACT-1	T cells
GAAACCTTCGAGAATA-1	pDC
GAAATGACACAACGTT-1	T cells
GAAATGAGTCAACCAT-1	T cells
GAACACTAGACGTCCC-1	B cells
GAACACTAGGGTCTTT-1	Monocytes
GAACACTGTCGCGTTG-1	T cells
GAACACTGTCTTCATT-1	Fibroblasts
GAACACTGTTTGAACC-1	T cells
GAACACTTCACTTCTA-1	T cells
GAACACTTCATACGGT-1	Epithelial cells
GAACGTTAGCTGTGCC-1	T cells
GAACGTTAGGGTGAGG-1	NK cells
GAACGTTCACCTGAAT-1	Monocytes
GAACGTTGTAACTAAG-1	T cells
GAACGTTGTTCGAAGG-1	Epithelial cells
GAACGTTTCCCGAATA-1	T cells
GAACGTTTCTTTCAGT-1	T cells
GAACTGTAGCTGAAGC-1	T cells
GAACTGTCAAGAATGT-1	T cells
GAACTGTCACTACCCT-1	Monocytes
GAACTGTTCAGTGCGC-1	T cells
GAAGAATAGTAGGTTA-1	B cells
GAAGAATCAATAACGA-1	Epithelial cells
GAAGAATCAGGTCCCA-1	T cells
GAAGAATGTCATACCA-1	B cells
GAAGAATGTGAGAGGG-1	Epithelial cells
GAAGAATTCTTGGTCC-1	Epithelial cells
GAAGCCCAGCCTCAAT-1	T cells
GAAGCCCCAGCAATTC-1	Epithelial cells
GAAGCCCGTCACCTTC-1	Monocytes
GAAGCCCGTTCTTGCC-1	T cells
GAAGCCCTCTCATGGA-1	Epithelial cells
GAAGCGAAGACGACTG-1	T cells
GAAGCGAAGAGGCTGT-1	T cells
GAAGCGAAGGTCGACA-1	T cells
GAAGCGACAGCACCCA-1	Epithelial cells
GAAGCGACATTCAGCA-1	T cells
GAAGCGACATTGAAGA-1	DC
GAAGCGAGTTCCGCTT-1	Monocytes
GAAGCGATCCGTGGGT-1	T cells
GAAGGACAGAGAACCC-1	Epithelial cells
GAAGGACGTAGTGTGG-1	Macrophages
GAAGGACTCCTAAACG-1	Monocytes
GAAGGGTAGAGGTTTA-1	T cells
GAAGGGTAGCCATCCG-1	Macrophages
GAAGGGTCACAGCATT-1	Macrophages
GAAGGGTTCCTCACCA-1	NK cells
GAAGGGTTCTGCGTCT-1	B cells
GAAGTAAAGCAGGTCA-1	T cells
GAAGTAACAAGACCTT-1	T cells
GAAGTAACACAGAAGC-1	T cells
GAAGTAACACTTCTCG-1	T cells
GAAGTAACAGGACGAT-1	B cells
GAAGTAACAGGTTCGC-1	pDC
GAAGTAACATGCCGAC-1	NK cells
GAAGTAAGTAACGCGA-1	T cells
GAAGTAAGTGGCTGCT-1	T cells
GAAGTAATCAGCTAGT-1	Epithelial cells
GAATAGAAGCACTAGG-1	T cells
GAATAGAAGGGTTGCA-1	Monocytes
GAATCACAGGTTCTTG-1	Fibroblasts
GAATCACCACTCTAGA-1	Epithelial cells
GAATCACTCACAGTGT-1	T cells
GAATCACTCCACACAA-1	DC
GAATCGTAGCTCGCAC-1	T cells
GAATCGTCAAAGGATT-1	NK cells
GAATCGTCATGTCAGT-1	T cells
GAATCGTTCCTTACCG-1	DC
GAATCGTTCTGGGAGA-1	B cells
GACACGCAGACGGATC-1	Epithelial cells
GACACGCGTCAATCTG-1	T cells
GACACGCGTCAGCTTA-1	DC
GACACGCGTCATAAAG-1	Macrophages
GACACGCGTGTTAAAG-1	T cells
GACACGCTCAGGTAAA-1	T cells
GACACGCTCGCAACAT-1	T cells
GACAGCCCACAACCGC-1	T cells
GACAGCCCACACGGTC-1	T cells
GACAGCCCATGTCGTA-1	T cells
GACAGCCGTTGCTCGG-1	Monocytes
GACAGCCTCAGTGTTG-1	Fibroblasts
GACATCAAGAAACACT-1	T cells
GACATCAAGCACCAGA-1	T cells
GACATCAAGCACGTCC-1	Epithelial cells
GACATCAAGCCGATCC-1	Macrophages
GACATCAAGGGCTGAT-1	T cells
GACATCATCCATTTAC-1	T cells
GACCAATCAGAGCCCT-1	T cells
GACCAATCAGAGGCTA-1	Monocytes
GACCAATTCCATTCGC-1	Epithelial cells
GACCAATTCCCGTGTT-1	T cells
GACCCAGAGCCTAACT-1	T cells
GACCCAGCAGAGTCAG-1	T cells
GACCCAGCATCCTTGC-1	T cells
GACCCAGGTGTAAATG-1	T cells
GACCCAGTCATTGCCC-1	Epithelial cells
GACCCTTAGGAGAGTA-1	Epithelial cells
GACCCTTGTTGGCCGT-1	Epithelial cells
GACCCTTGTTGGGACA-1	T cells
GACCCTTTCTATACTC-1	Epithelial cells
GACCCTTTCTTTGCGC-1	T cells
GACCGTGAGCATCAAA-1	Epithelial cells
GACCGTGAGCGGTATG-1	T cells
GACCGTGCAAACGTGG-1	pDC
GACCGTGCATCAGCTA-1	T cells
GACCGTGGTAAGATCA-1	T cells
GACCGTGGTAGGAAAG-1	T cells
GACCGTGGTCCGTTTC-1	T cells
GACCGTGGTCGACTGC-1	T cells
GACCGTGTCGAGCCAC-1	T cells
GACCGTGTCGCGCTGA-1	B cells
GACCTTCAGGCATGCA-1	Epithelial cells
GACCTTCGTTAAGACA-1	B cells
GACCTTCTCCATTGCC-1	T cells
GACGCTGAGCGTGAAC-1	T cells
GACGCTGAGTACCATC-1	DC
GACGCTGAGTATGCAA-1	T cells
GACGCTGTCCCGAGAC-1	Monocytes
GACGTTAAGAGCACTG-1	T cells
GACGTTAGTCGGAACA-1	T cells
GACGTTATCATACAGC-1	Macrophages
GACGTTATCATACGAC-1	T cells
GACGTTATCGAGTGGA-1	T cells
GACGTTATCTATGTGG-1	Epithelial cells
GACTATGAGAGCTTTC-1	T cells
GACTATGGTCCAGTTA-1	T cells
GACTATGGTCCTTAAG-1	T cells
GACTATGGTTTCCAAG-1	T cells
GACTCAAAGCCTTCTC-1	DC
GACTCAAGTTCTATCT-1	Epithelial cells
GACTCAATCAGTCAGT-1	T cells
GACTCAATCCGTTGGG-1	T cells
GACTCAATCTAACGCA-1	T cells
GACTCTCAGGCATGCA-1	Plasma cells
GACTCTCCACATGGTT-1	Macrophages
GACTCTCCATGGGCAA-1	DC
GACTCTCTCGGCTATA-1	Monocytes
GACTGATAGATACATG-1	Epithelial cells
GACTGATCACATGGTT-1	Epithelial cells
GACTGATCAGCCTACG-1	T cells
GACTGATTCTGCTAGA-1	T cells
GACTGATTCTTTGCTA-1	Monocytes
GACTTCCAGATGGGCT-1	T cells
GACTTCCAGCCATTGT-1	T cells
GACTTCCAGCGACTTT-1	T cells
GACTTCCGTCTAGGCC-1	T cells
GACTTCCTCATGTCAG-1	T cells
GACTTCCTCGTTACCC-1	Epithelial cells
GAGAAATAGGGAGGTG-1	pDC
GAGAAATCATGGAGAC-1	Epithelial cells
GAGAAATGTCCCGCAA-1	T cells
GAGAAATGTCCTCAGG-1	Epithelial cells
GAGAAATGTTTCTTAC-1	B cells
GAGAAATTCAGACCGC-1	Monocytes
GAGACCCCACCGTGAC-1	T cells
GAGACCCGTATCGCGC-1	B cells
GAGACCCGTGCTGCAC-1	T cells
GAGACCCTCCGCTGTT-1	T cells
GAGACTTAGAATCGAT-1	T cells
GAGACTTAGCATCAGG-1	T cells
GAGACTTCAAAGAACT-1	T cells
GAGACTTCACGTCGGT-1	DC
GAGACTTGTCAGTCCG-1	T cells
GAGACTTGTTTCGTTT-1	Plasma cells
GAGAGGTAGTATCTGC-1	T cells
GAGAGGTCACGGTGAA-1	T cells
GAGAGGTGTCGCAACC-1	Epithelial cells
GAGAGGTTCCATCCGT-1	T cells
GAGAGGTTCCCTCGTA-1	NK cells
GAGAGGTTCGCCTCTA-1	Epithelial cells
GAGATGGCAGAAGCGT-1	T cells
GAGCCTGCACGTGAGA-1	T cells
GAGCCTGCAGATACCT-1	DC
GAGCCTGCAGCCTTCT-1	T cells
GAGCCTGGTCCTATAG-1	T cells
GAGCCTGTCACAGTGT-1	T cells
GAGCCTGTCAGCTGTA-1	Macrophages
GAGCTGCAGCTTGTTG-1	Epithelial cells
GAGCTGCAGGGTCAAC-1	T cells
GAGCTGCCACCCTGTT-1	T cells
GAGCTGCCAGGTTACT-1	Macrophages
GAGCTGCCATCGATAC-1	DC
GAGCTGCGTAGATCGG-1	T cells
GAGCTGCGTGCGTTTA-1	T cells
GAGCTGCGTTGTGCAT-1	Epithelial cells
GAGCTGCTCCAATGCA-1	T cells
GAGGCAAAGATAACGT-1	Macrophages
GAGGCAAAGCTACTAC-1	Epithelial cells
GAGGCAATCCCAGGCA-1	T cells
GAGGCCTAGGCATGCA-1	T cells
GAGGCCTCATACATCG-1	T cells
GAGGCCTCATTGAGGG-1	Epithelial cells
GAGGCCTGTACAACGG-1	T cells
GAGGCCTTCCCTCTCC-1	Epithelial cells
GAGGCCTTCGAGATAA-1	T cells
GAGGGATAGCGAGTCA-1	T cells
GAGGGATAGCGTCAAG-1	NK cells
GAGGGATCACTAACCA-1	Macrophages
GAGGGATCATGTTACG-1	T cells
GAGGGATTCCGGTAAT-1	T cells
GAGGGATTCGGCTGTG-1	Macrophages
GAGGGATTCGTTCATT-1	T cells
GAGGGTAAGCTCCACG-1	NK cells
GAGGGTAAGTGCCAGA-1	Macrophages
GAGGGTACAACCGACC-1	Macrophages
GAGGGTATCTGAATCG-1	Macrophages
GAGTCATCAAACTAAG-1	B cells
GAGTCATCACAAAGCG-1	T cells
GAGTCATCACTAGGCC-1	Epithelial cells
GAGTCATCAGTAGAGC-1	NK cells
GAGTCATCATCGGTTA-1	T cells
GAGTCATGTAGCCAGA-1	T cells
GAGTCATGTATGGGAC-1	Macrophages
GAGTCATGTCTCTCTG-1	T cells
GAGTCATTCCTGTAAG-1	T cells
GAGTCATTCTCTCTAA-1	T cells
GAGTCTAAGGGAACAA-1	Epithelial cells
GAGTCTACACAGCCAC-1	DC
GAGTCTACACCCGTAG-1	T cells
GAGTCTACAGCGATTT-1	T cells
GAGTCTAGTACCATAC-1	T cells
GAGTCTAGTATTCTCT-1	B cells
GAGTCTAGTGCAATGG-1	T cells
GAGTCTATCAACGTGT-1	Monocytes
GAGTGAGCATGAGGGT-1	T cells
GAGTGAGGTCTACACA-1	DC
GAGTGAGTCACCGGTG-1	T cells
GAGTGAGTCCTTTGAT-1	Monocytes
GAGTGAGTCGGTGCAC-1	Monocytes
GAGTGAGTCGTCGATA-1	T cells
GAGTGTTAGCTGACTT-1	Epithelial cells
GAGTGTTCAACTGCCG-1	T cells
GAGTGTTCACCGTGCA-1	pDC
GAGTGTTCATAATCGC-1	Monocytes
GAGTGTTGTCGTATTG-1	pDC
GAGTGTTTCAACCGAT-1	T cells
GAGTTACAGTGCTCGC-1	Epithelial cells
GAGTTACGTAACATCC-1	Epithelial cells
GAGTTACTCCCTATTA-1	T cells
GAGTTACTCCTGCCAT-1	Epithelial cells
GAGTTGTAGAGCATCG-1	NK cells
GAGTTGTAGTGGCCTC-1	Epithelial cells
GAGTTGTGTCTAGGCC-1	T cells
GAGTTGTGTTCTTCAT-1	T cells
GAGTTGTTCGCCCAGA-1	Macrophages
GAGTTGTTCGCCGAGT-1	Fibroblasts
GAGTTTGCAAATAAGC-1	Epithelial cells
GAGTTTGCACAAGTGG-1	T cells
GAGTTTGCAGATCATC-1	Epithelial cells
GAGTTTGTCGTCAACA-1	T cells
GATAGAAAGATCACCT-1	T cells
GATAGAAAGCCGTTAT-1	B cells
GATAGAAAGGATACGC-1	NK cells
GATAGAATCCCGAATA-1	T cells
GATAGAATCTGAGATC-1	T cells
GATAGAATCTTTCGAT-1	NK cells
GATAGCTAGTTGCATC-1	T cells
GATAGCTCAAATGCTC-1	T cells
GATAGCTCAGGTCCCA-1	Macrophages
GATAGCTTCTCGAGTA-1	B cells
GATCACAAGGCGAAGG-1	NK cells
GATCACAAGGTCCGAA-1	T cells
GATCACACAGACCTAT-1	T cells
GATCAGTAGTGAGGTC-1	T cells
GATCAGTCAACACGAG-1	Plasma cells
GATCAGTCACTTTATC-1	NK cells
GATCAGTGTCTCGGAC-1	T cells
GATCAGTGTTATTCTC-1	Epithelial cells
GATCATGAGCGAACTG-1	Epithelial cells
GATCATGAGGCCTTCG-1	T cells
GATCATGAGGTTGAGC-1	Fibroblasts
GATCATGCAGCTCATA-1	T cells
GATCATGGTCACAATC-1	T cells
GATCATGGTCAGATTC-1	T cells
GATCATGGTCATCCCT-1	T cells
GATCATGGTGAGAGGG-1	Monocytes
GATCATGGTTATGACC-1	pDC
GATCATGGTTTCACTT-1	Monocytes
GATCATGTCAAGCCAT-1	Macrophages
GATCATGTCACTGAAC-1	T cells
GATCATGTCCCATGGG-1	T cells
GATCATGTCTAGCATG-1	Epithelial cells
GATCCCTAGAAGCGCT-1	Epithelial cells
GATCCCTAGCAAGTGC-1	T cells
GATCCCTAGGTTACAA-1	T cells
GATCCCTCACGGGTAA-1	T cells
GATCCCTGTACTGACT-1	Endothelial cells
GATCCCTTCAAGTCTG-1	DC
GATCCCTTCCGAGGCT-1	Epithelial cells
GATCGTAAGCAGTCTT-1	Epithelial cells
GATCGTACACTGCGAC-1	T cells
GATGACTAGACTGTTC-1	Epithelial cells
GATGACTAGCATAGGC-1	T cells
GATGACTAGCTAGTTC-1	T cells
GATGACTAGGCATTTC-1	NK cells
GATGACTGTACAAACA-1	T cells
GATGACTGTACCATAC-1	B cells
GATGACTTCCCTGTTG-1	pDC
GATGACTTCGATACTG-1	T cells
GATGACTTCTCCGTGT-1	T cells
GATGAGGAGCGTTAGG-1	pDC
GATGAGGAGTGCACCC-1	NK cells
GATGAGGCAGGTACGA-1	T cells
GATGAGGGTGCTCCGA-1	NK cells
GATGAGGGTTCCGGTG-1	T cells
GATGATCCATCCCACT-1	T cells
GATGATCGTGACCGAA-1	T cells
GATGATCGTTGGACTT-1	DC
GATGATCTCCAACTGA-1	B cells
GATGCTAAGGGTATAT-1	T cells
GATGCTAAGTCGTCTA-1	T cells
GATGCTAGTATGCAAA-1	NK cells
GATGCTATCAAAGAAC-1	T cells
GATGCTATCAAGGTGG-1	T cells
GATGCTATCACCCTGT-1	Macrophages
GATGCTATCCACCTCA-1	DC
GATGGAGAGAACTCCT-1	T cells
GATGGAGAGGTCCCTG-1	NK cells
GATGGAGAGGTTCCGC-1	NK cells
GATGGAGGTGTCCAAT-1	Epithelial cells
GATGGAGTCCAAGCAT-1	T cells
GATGGAGTCCTTCTGG-1	T cells
GATGTTGAGATTAGAC-1	B cells
GATGTTGAGTATGCAA-1	T cells
GATGTTGAGTTGGCTT-1	Epithelial cells
GATGTTGCAACGATCT-1	T cells
GATGTTGCAGTAACAA-1	T cells
GATGTTGCATCATCCC-1	Monocytes
GATGTTGGTAGTATAG-1	Epithelial cells
GATGTTGGTGTACAGG-1	T cells
GATGTTGTCATGGAGG-1	Epithelial cells
GATGTTGTCATTCTTG-1	DC
GATGTTGTCGGATAAA-1	Epithelial cells
GATGTTGTCGGTTCAA-1	T cells
GATGTTGTCGTCAAAC-1	Plasma cells
GATGTTGTCTTTGGAG-1	T cells
GATTCGAAGCTCGCAC-1	T cells
GATTCGAAGGAATGTT-1	Monocytes
GATTCGACAGGACAGT-1	Macrophages
GATTCTTAGCGCTTCG-1	T cells
GATTCTTGTACTAACC-1	T cells
GATTCTTGTTGGTGTT-1	T cells
GATTCTTTCAATCCGA-1	Epithelial cells
GATTGGTCACTATGTG-1	T cells
GATTGGTCAGGAGGAG-1	T cells
GATTGGTGTATGAGCG-1	T cells
GATTGGTTCAACGTGT-1	Epithelial cells
GATTTCTCAATCAGCT-1	T cells
GATTTCTGTATTCCTT-1	B cells
GCAACATAGAGGGTCT-1	DC
GCAACATAGTTACGAA-1	T cells
GCAACATCAAAGGCGT-1	NK cells
GCAACATCAGCGTAGA-1	Macrophages
GCAACATCATCGTCCT-1	B cells
GCAACATCATGGAGAC-1	T cells
GCAACATCATGTAACC-1	T cells
GCAACATGTCACAGAG-1	T cells
GCAACATGTTCCCACT-1	T cells
GCAACCGAGTTCGGTT-1	B cells
GCAACCGGTGGCCCAT-1	T cells
GCAACCGGTTAGGGTG-1	Epithelial cells
GCACATAAGCCTTCTC-1	Epithelial cells
GCACATACAACAACAA-1	T cells
GCACATAGTACCGTGC-1	NK cells
GCACATAGTTTACTGG-1	T cells
GCACATATCCAAATGC-1	T cells
GCACGGTAGATACATG-1	Epithelial cells
GCACGGTTCGTGTGAT-1	Macrophages
GCACGGTTCTGGCTGG-1	B cells
GCACGTGAGATGAAGG-1	Macrophages
GCACGTGAGGACAAGA-1	Epithelial cells
GCACGTGAGTTGGACG-1	Macrophages
GCACGTGCACCTCTGT-1	T cells
GCACGTGCAGAATGTA-1	T cells
GCACGTGCATAATCGC-1	Epithelial cells
GCACTAAAGTGATGGC-1	T cells
GCACTAAAGTGTACCT-1	T cells
GCACTAACAACGCCCA-1	T cells
GCACTAAGTACTGCGC-1	T cells
GCACTAAGTCGTATTG-1	Fibroblasts
GCAGCCAAGCGATGCA-1	T cells
GCAGCCAAGGTTGGAC-1	DC
GCAGCCACAAGGATGC-1	Macrophages
GCAGCCACACATTGTG-1	Fibroblasts
GCAGCCAGTGCGGATA-1	Fibroblasts
GCAGCCATCCACGTGG-1	T cells
GCAGCCATCCCGAAAT-1	Epithelial cells
GCAGCCATCGAGATGG-1	T cells
GCAGCCATCGCTTACC-1	Epithelial cells
GCAGCCATCGTAACAC-1	Macrophages
GCAGCTGAGGAACTAT-1	T cells
GCAGCTGCACTTTATC-1	Mast cells
GCAGCTGTCCTCACTG-1	T cells
GCAGCTGTCTCTATGT-1	T cells
GCAGGCTAGACTACGG-1	T cells
GCAGGCTAGGGTACGT-1	Monocytes
GCAGGCTAGTGCGTCC-1	T cells
GCAGGCTAGTTGCTGT-1	T cells
GCAGGCTCAAGGTCTT-1	T cells
GCAGGCTCACGGTGCT-1	Macrophages
GCAGGCTCAGGCTCTG-1	Macrophages
GCAGGCTGTGGAAATT-1	T cells
GCAGGCTTCGGTCAGC-1	Epithelial cells
GCAGTTACACTGGACC-1	B cells
GCAGTTACATGTACGT-1	Macrophages
GCAGTTAGTAGCGAGT-1	T cells
GCAGTTAGTCCGCAGT-1	T cells
GCAGTTAGTGGTATGG-1	T cells
GCAGTTATCAAAGAAC-1	T cells
GCAGTTATCACCCTTG-1	T cells
GCAGTTATCATTCTTG-1	Epithelial cells
GCATCGGAGATTAGCA-1	T cells
GCATCGGGTCATGGCC-1	T cells
GCATCGGGTGTTGCCG-1	T cells
GCATCGGGTTACACTG-1	Epithelial cells
GCATCGGGTTATCCAG-1	Macrophages
GCATCTCAGAGCACTG-1	Epithelial cells
GCATCTCAGCACTAGG-1	DC
GCATCTCAGGCATCGA-1	T cells
GCATCTCCAAGACCTT-1	T cells
GCATCTCCAGCTAACT-1	T cells
GCATCTCCATCTCATT-1	T cells
GCATCTCGTTATGACC-1	NK cells
GCATGATAGACGATAT-1	Mast cells
GCATGATAGTATGACA-1	T cells
GCATGATGTACAGTAA-1	B cells
GCATGATGTCACTACA-1	Monocytes
GCATGATGTGCAAGAC-1	T cells
GCATTAGCACATTCTT-1	B cells
GCATTAGCATCCAATG-1	Macrophages
GCATTAGGTGCATGAG-1	Macrophages
GCATTAGGTTAACAGA-1	NK cells
GCCAACGAGAAGCGAA-1	B cells
GCCAACGAGAAGTCAT-1	Epithelial cells
GCCAACGCAGGATTCT-1	T cells
GCCAACGCAGTCCGTG-1	T cells
GCCAACGGTCACTCGG-1	Epithelial cells
GCCAACGGTTTCAGAC-1	Epithelial cells
GCCAACGTCATGCCAA-1	DC
GCCAACGTCGAGAACG-1	T cells
GCCAACGTCTTGCAAG-1	Macrophages
GCCAGCAAGAATACAC-1	T cells
GCCAGCAAGCATCAGG-1	T cells
GCCAGCACAGAGTTGG-1	B cells
GCCAGCACAGCTTTCC-1	pDC
GCCAGCAGTCCAGTTA-1	T cells
GCCAGCAGTCGTCTCT-1	T cells
GCCAGCAGTTTGGCTA-1	T cells
GCCAGCATCCACTGGG-1	T cells
GCCAGCATCCTTCTGG-1	pDC
GCCAGCATCGCCGAAC-1	T cells
GCCAGCATCGTTACCC-1	T cells
GCCAGGTAGGTCCGAA-1	DC
GCCAGGTAGTATGACA-1	Monocytes
GCCAGGTTCATCGCTC-1	B cells
GCCAGTGAGGCCCGTT-1	T cells
GCCAGTGGTAGGACCA-1	T cells
GCCATGGAGCTGGCCT-1	Epithelial cells
GCCATGGAGTGTAGTA-1	T cells
GCCATGGCAACGTAAA-1	Epithelial cells
GCCATGGCAATCTCTT-1	T cells
GCCATGGGTCTGTCCT-1	Epithelial cells
GCCATGGGTTCGAAGG-1	T cells
GCCATGGTCATACGAC-1	Monocytes
GCCATGGTCCAGGACC-1	T cells
GCCATTCAGGACGGAG-1	T cells
GCCATTCAGTTGCCTA-1	NK cells
GCCATTCCACGTAGTT-1	NK cells
GCCCAGACAATGAACA-1	T cells
GCCCAGACACCTCGTT-1	Epithelial cells
GCCCAGACAGTAACGG-1	T cells
GCCCAGATCAGAACCT-1	Epithelial cells
GCCCAGATCAGTGCGC-1	T cells
GCCCGAAAGATGTTCC-1	T cells
GCCCGAAGTGAACCGA-1	Macrophages
GCCCGAAGTTCCCAAA-1	T cells
GCCCGAATCCATTTCA-1	T cells
GCCCGAATCTGCTGAA-1	T cells
GCCCGAATCTTGTTAC-1	Epithelial cells
GCCGATGAGGAAAGGT-1	T cells
GCCGATGAGTCCCAAT-1	T cells
GCCGATGCAAGTCCCG-1	T cells
GCCGATGGTCTCAGGC-1	Fibroblasts
GCCGATGGTGACTCTA-1	Epithelial cells
GCCGATGTCTGTCCGT-1	Epithelial cells
GCCGTGAAGCTAAGTA-1	DC
GCCGTGATCACTTTGT-1	T cells
GCCGTGATCATCGACA-1	T cells
GCCTGTTAGAGGCCAT-1	T cells
GCCTGTTAGCGTTCCG-1	T cells
GCCTGTTAGTATGCAA-1	T cells
GCCTGTTCACCCTTAC-1	T cells
GCCTGTTCACTTTAGG-1	Epithelial cells
GCCTGTTCATATTCGG-1	Epithelial cells
GCCTGTTGTAACTTCG-1	T cells
GCCTGTTTCACCATGA-1	Macrophages
GCGAGAACAATGTGGG-1	T cells
GCGAGAACACAAAGTA-1	T cells
GCGAGAAGTAGTGTGG-1	Epithelial cells
GCGAGAAGTATCCTCC-1	Macrophages
GCGAGAAGTCTTCTAT-1	T cells
GCGATCGGTCTCGCGA-1	Macrophages
GCGATCGGTTAAGAAC-1	T cells
GCGATCGTCCCGAGTG-1	Epithelial cells
GCGGAAACAGGACGAT-1	T cells
GCGGAAAGTAGAGCTG-1	T cells
GCGGAAAGTATCGAGG-1	Macrophages
GCGGAAATCTGAGTCA-1	Macrophages
GCGGATCAGGAGCAAA-1	DC
GCGGATCAGTCACGAG-1	T cells
GCGGATCGTCAGCTTA-1	T cells
GCGGATCTCTCTGAGA-1	T cells
GCGTGCAGTTAAACAG-1	T cells
GCGTGCAGTTACGCCG-1	T cells
GCGTGCATCACGGTCG-1	T cells
GCGTTTCAGCCTCAAT-1	T cells
GCGTTTCAGTAAGACT-1	T cells
GCGTTTCAGTGCACTT-1	T cells
GCGTTTCCAAACCACT-1	T cells
GCGTTTCGTCCACTCT-1	Epithelial cells
GCGTTTCTCCATGATG-1	Epithelial cells
GCGTTTCTCCGGACTG-1	Fibroblasts
GCGTTTCTCCGGTAAT-1	Macrophages
GCTACAAAGTTAGTAG-1	B cells
GCTACAACAATTTCGG-1	B cells
GCTACAAGTAATTGGA-1	NK cells
GCTACAAGTGAAAGTT-1	T cells
GCTACAATCACCTCTG-1	T cells
GCTACCTAGACCGCCT-1	NK cells
GCTACCTAGATCCTAC-1	T cells
GCTACCTAGCGATTCT-1	T cells
GCTACCTCAATCCTAG-1	Epithelial cells
GCTACCTGTCATCGCG-1	NK cells
GCTACCTGTGGCTGAA-1	T cells
GCTACCTTCTACTATC-1	NK cells
GCTCAAATCAACTGAC-1	T cells
GCTGAATAGATGTTCC-1	T cells
GCTGAATAGTGGCGAT-1	T cells
GCTGAATCAATACGAA-1	Epithelial cells
GCTGAATGTACGGGAT-1	Epithelial cells
GCTGAATTCAGCGGAA-1	T cells
GCTGAATTCATCACAG-1	T cells
GCTGAATTCGGCCCAA-1	Macrophages
GCTGCAGAGATGCTAA-1	T cells
GCTGCAGAGTGCAACG-1	NK cells
GCTGCAGCAAGTGCTT-1	T cells
GCTGCAGCACGTACAT-1	Macrophages
GCTGCAGCAGAGGTTG-1	T cells
GCTGCAGGTACAGCGA-1	T cells
GCTGCAGTCTCCATAT-1	T cells
GCTGGGTAGCGACATG-1	B cells
GCTGGGTAGTAAACAC-1	T cells
GCTGGGTCATGCCGCA-1	Macrophages
GCTGGGTCATGGCTAT-1	Macrophages
GCTGGGTGTACTGACT-1	T cells
GCTGGGTGTATTTCCT-1	Epithelial cells
GCTGGGTGTGGCTTAT-1	Epithelial cells
GCTGGGTTCCACACAA-1	Epithelial cells
GCTTCACAGGTCGTAG-1	pDC
GCTTCACCAAAGGCGT-1	NK cells
GCTTCACGTAGAGGAA-1	T cells
GCTTCACGTAGGAGTC-1	Epithelial cells
GCTTCACGTCCGGCAT-1	T cells
GCTTCACTCTGTACAG-1	Macrophages
GCTTGGGAGTTGGACG-1	Epithelial cells
GCTTGGGCAAAGCTCT-1	Epithelial cells
GCTTGGGCACCGTACG-1	T cells
GCTTTCGAGCCTCTGG-1	Macrophages
GCTTTCGCATACCGTA-1	T cells
GCTTTCGGTCAACACT-1	NK cells
GCTTTCGGTCCCACGA-1	DC
GCTTTCGGTGCTCTTC-1	T cells
GGAACCCCAAATGAAC-1	T cells
GGAACCCCAAGTGGCA-1	T cells
GGAACCCGTCCAAATC-1	NK cells
GGAACCCGTTGGGATG-1	Fibroblasts
GGAACCCTCACGATCA-1	NK cells
GGAACCCTCATGTCTT-1	Macrophages
GGAACCCTCCACGTAA-1	T cells
GGAAGTGGTCGTATGT-1	B cells
GGAAGTGGTTGTCAGT-1	Macrophages
GGAAGTGTCTACCCAC-1	Monocytes
GGAATCTAGCTATCTG-1	DC
GGAATCTAGGCCTGAA-1	T cells
GGAATCTAGGTTCCGC-1	T cells
GGAATCTCAAATGGCG-1	Macrophages
GGAATCTCAATAACCC-1	T cells
GGAATCTTCAGGAAAT-1	Epithelial cells
GGAATGGAGAATTCAG-1	T cells
GGAATGGAGCAATTAG-1	T cells
GGAATGGCACAGTACT-1	T cells
GGAATGGCACTCTCGT-1	T cells
GGAATGGCAGATCATC-1	B cells
GGAATGGCAGCAGTAG-1	T cells
GGAATGGGTGTCATCA-1	T cells
GGAATGGTCTGTCGCT-1	T cells
GGACGTCAGGCCTAAG-1	T cells
GGACGTCAGGGCAAGG-1	T cells
GGACGTCCAATTGCTG-1	Macrophages
GGACGTCCACATATCG-1	T cells
GGACGTCCACATCCCT-1	T cells
GGACGTCCAGTAACGG-1	Fibroblasts
GGACGTCTCTTTGCAT-1	pDC
GGAGAACAGAATCGTA-1	Epithelial cells
GGAGAACCACTACCCT-1	T cells
GGAGAACCAGACCATT-1	T cells
GGAGAACCATAGTCAC-1	T cells
GGAGAACTCTCGACCT-1	T cells
GGAGATGAGCGGATCA-1	Endothelial cells
GGAGATGAGGCCCAAA-1	T cells
GGAGATGTCCTCAGGG-1	Epithelial cells
GGAGATGTCTCATAGG-1	T cells
GGAGCAACACTACTTT-1	NK cells
GGAGCAACAGTACTAC-1	T cells
GGAGCAACATCCGTGG-1	T cells
GGAGCAACATTGAAAG-1	DC
GGAGCAAGTAATGCGG-1	Epithelial cells
GGAGCAATCACCATAG-1	T cells
GGAGCAATCACCTTAT-1	T cells
GGAGCAATCCCGTTCA-1	T cells
GGAGCAATCTCATGGA-1	T cells
GGAGGATGTCACTGAT-1	T cells
GGAGGATTCACCGGGT-1	Epithelial cells
GGAGGTACAATCCTTT-1	Epithelial cells
GGAGGTAGTAATTAGG-1	T cells
GGAGGTATCGAACCTA-1	T cells
GGAGGTATCTCCAAGA-1	T cells
GGATCTAAGAATTGCA-1	T cells
GGATCTAAGCCGATCC-1	T cells
GGATCTAAGGTCATTC-1	Epithelial cells
GGATCTAAGGTCGAGT-1	Macrophages
GGATCTACAGACAAAT-1	T cells
GGATCTACAGAGGACT-1	Epithelial cells
GGATCTAGTACATACC-1	T cells
GGATCTATCGGCTTCT-1	T cells
GGATGTTCAAGGTTGG-1	DC
GGATGTTCACAAATAG-1	Epithelial cells
GGATGTTCAGCGTGAA-1	T cells
GGATGTTGTTCTCAGA-1	T cells
GGATGTTTCGCAGAGA-1	T cells
GGATGTTTCGGATACT-1	NK cells
GGCACGTCAATCACGT-1	pDC
GGCACGTTCTCCCTAG-1	T cells
GGCAGTCCACTCTAGA-1	Epithelial cells
GGCAGTCCAGAGACTG-1	Fibroblasts
GGCAGTCGTGTAAACA-1	T cells
GGCAGTCTCGAGCTGC-1	B cells
GGCGTCAAGAGAGTTT-1	T cells
GGCGTCAGTAAGGAGA-1	T cells
GGCGTCATCTCTGCTG-1	Macrophages
GGCTGTGCAGTGACCC-1	Fibroblasts
GGCTTGGAGAGGGTAA-1	Macrophages
GGCTTGGAGCATGCGA-1	T cells
GGCTTGGAGGCCTTGC-1	T cells
GGCTTGGAGTCTTGGT-1	T cells
GGCTTGGGTAAGACCG-1	Macrophages
GGCTTGGGTACTGGGA-1	T cells
GGCTTGGGTCGCATTA-1	T cells
GGCTTTCAGATGTTAG-1	T cells
GGCTTTCCAGCAGTCC-1	B cells
GGCTTTCGTAGCTTTG-1	Epithelial cells
GGCTTTCGTTCTTGTT-1	T cells
GGCTTTCTCACTGTTT-1	Macrophages
GGCTTTCTCATGTCTT-1	Epithelial cells
GGCTTTCTCCACACCT-1	T cells
GGCTTTCTCCCACAGG-1	Epithelial cells
GGCTTTCTCGATCCAA-1	Fibroblasts
GGGACAAAGCATCCTA-1	Epithelial cells
GGGACAAAGCCTAGGA-1	T cells
GGGACAACAGAGATGC-1	T cells
GGGACAATCCACCCTA-1	T cells
GGGACAATCTTCGGAA-1	Epithelial cells
GGGACCTAGGACAACC-1	T cells
GGGACCTGTACAGTAA-1	NK cells
GGGACCTTCTCCGCAT-1	Epithelial cells
GGGACTCGTTGGGTTT-1	T cells
GGGACTCTCCGGACTG-1	T cells
GGGAGATAGGTGCCAA-1	T cells
GGGAGATCATAATGCC-1	Epithelial cells
GGGAGATTCGCTAATG-1	T cells
GGGAGTAAGGCAATGC-1	B cells
GGGAGTAAGTGATAAC-1	Fibroblasts
GGGAGTACAAGAGTTA-1	T cells
GGGAGTACACAAGCAG-1	T cells
GGGAGTACATAGTCAC-1	T cells
GGGAGTAGTAATGATG-1	Epithelial cells
GGGAGTAGTTACCCAA-1	Epithelial cells
GGGAGTATCAGCTGAT-1	T cells
GGGAGTATCTAAGAAG-1	Plasma cells
GGGAGTATCTATCGGA-1	Monocytes
GGGATCCAGCCTATCA-1	T cells
GGGATCCAGGCCTGCT-1	Macrophages
GGGATCCAGGGCAACT-1	T cells
GGGATCCAGTATAGAC-1	NK cells
GGGATCCAGTCAATCC-1	T cells
GGGATCCCAGACTCTA-1	T cells
GGGATCCGTCCCTGTT-1	Macrophages
GGGATCCGTGGCGCTT-1	T cells
GGGATCCGTTGGAGAC-1	B cells
GGGATCCTCAATCCGA-1	T cells
GGGATGAAGTATAGAC-1	T cells
GGGATGACAAGTCCAT-1	T cells
GGGATGACACTTTAGG-1	Epithelial cells
GGGATGACAGAACTTC-1	Epithelial cells
GGGATGACATTCCTAT-1	Epithelial cells
GGGATGATCAGCTGAT-1	T cells
GGGCCATCAAGGCTTT-1	Epithelial cells
GGGCCATCAATGCAAA-1	Epithelial cells
GGGCCATCACACTTAG-1	B cells
GGGCCATCATGCCGGT-1	T cells
GGGCGTTAGCATGCAG-1	B cells
GGGCGTTAGGGTAATT-1	Macrophages
GGGCGTTAGTTTGTCG-1	T cells
GGGCGTTGTGCCTAAT-1	Epithelial cells
GGGCGTTGTTTCTTAC-1	Monocytes
GGGCGTTTCCTCTAGC-1	Macrophages
GGGCGTTTCGCCGAGT-1	T cells
GGGCGTTTCTCAGAAC-1	T cells
GGGCTACAGCATCAGG-1	T cells
GGGCTACAGGCTAAAT-1	T cells
GGGCTACAGTACCCTA-1	T cells
GGGCTACGTAGCGTTT-1	T cells
GGGCTACTCGCAGTTA-1	T cells
GGGCTCAAGCACTCTA-1	T cells
GGGCTCAAGGAAAGTG-1	DC
GGGCTCACAATGCTCA-1	T cells
GGGCTCACACCAACAT-1	pDC
GGGCTCACATTGACAC-1	T cells
GGGCTCAGTCATAACC-1	T cells
GGGCTCAGTCGTTTCC-1	DC
GGGCTCAGTCTCCCTA-1	T cells
GGGCTCATCAACGCTA-1	T cells
GGGTAGACAGATAAAC-1	Epithelial cells
GGGTATTAGAAGCGCT-1	T cells
GGGTATTCAAGCTCTA-1	T cells
GGGTATTCAATCGTCA-1	T cells
GGGTATTCATACTTTC-1	T cells
GGGTATTGTCTTCGAA-1	T cells
GGGTCACAGAGGACTC-1	T cells
GGGTCACCAAGATGTA-1	Epithelial cells
GGGTCACCAGAACGCA-1	T cells
GGGTCACGTATGGTAA-1	T cells
GGGTCACGTCTAGGTT-1	T cells
GGGTCACGTGGAAATT-1	T cells
GGGTCACTCTGAGAAA-1	T cells
GGGTCACTCTGGCTGG-1	T cells
GGGTCTGAGAATCTAG-1	Plasma cells
GGGTCTGAGGCAATGC-1	DC
GGGTCTGCAGGTACGA-1	NK cells
GGGTCTGGTATCCCAA-1	T cells
GGGTCTGGTGACTCTA-1	DC
GGGTCTGTCGGCATCG-1	T cells
GGGTGAAAGAGCCGAT-1	T cells
GGGTGAAAGTAGTGCG-1	T cells
GGGTGAACACGGGTAA-1	T cells
GGGTGAACAGTACTAC-1	Epithelial cells
GGGTGAAGTTTCGATG-1	Macrophages
GGGTGAATCACTGGGC-1	T cells
GGGTGTCGTCAGTTTG-1	T cells
GGGTGTCTCTGCTCTG-1	T cells
GGGTTATAGGATTCAA-1	T cells
GGGTTATAGTACAGAT-1	Epithelial cells
GGGTTATCACAATGAA-1	Epithelial cells
GGGTTATGTTCAACGT-1	Epithelial cells
GGGTTATTCAACGCTA-1	T cells
GGGTTATTCTCAACGA-1	DC
GGGTTATTCTTCTGGC-1	Macrophages
GGGTTTAGTCGCATCG-1	NK cells
GGGTTTAGTTGCCGCA-1	T cells
GGGTTTATCATGTCTT-1	Fibroblasts
GGGTTTATCCACGTGG-1	B cells
GGGTTTATCGGCGATC-1	Epithelial cells
GGGTTTATCTGGCTGG-1	T cells
GGTAACTAGAGACAAG-1	Epithelial cells
GGTAACTCACACACGC-1	T cells
GGTAACTTCTGTCGTC-1	T cells
GGTAATCAGATTGGGC-1	T cells
GGTAATCAGCTCAGAG-1	Epithelial cells
GGTAATCCACTACCCT-1	T cells
GGTAGAGAGCCGATCC-1	Epithelial cells
GGTAGAGAGGCCACCT-1	NK cells
GGTAGAGCAAAGGCTG-1	T cells
GGTAGAGGTAAGAACT-1	DC
GGTAGAGTCCGATGCG-1	T cells
GGTCACGAGGATACCG-1	Epithelial cells
GGTCACGCAAGCACAG-1	DC
GGTCACGCAGCTTCGG-1	T cells
GGTCACGGTATCGCTA-1	Epithelial cells
GGTCACGGTGTTATCG-1	T cells
GGTCACGGTTACACAC-1	T cells
GGTCACGTCAATGTCG-1	Macrophages
GGTCACGTCATAGGCT-1	Epithelial cells
GGTCACGTCCTGTACC-1	T cells
GGTCTGGCATACCACA-1	Epithelial cells
GGTCTGGGTACAAGTA-1	Epithelial cells
GGTCTGGTCAGAACCT-1	T cells
GGTGAAGAGAGTACCG-1	T cells
GGTGAAGAGATCGACG-1	Fibroblasts
GGTGAAGAGGTTCTTG-1	Macrophages
GGTGAAGGTAATTGGA-1	Monocytes
GGTGAAGGTATGGTAA-1	T cells
GGTGAAGGTTGTTGTG-1	Epithelial cells
GGTGAAGTCACTACGA-1	Fibroblasts
GGTGAAGTCAGACCCG-1	T cells
GGTGATTAGACTTGTC-1	T cells
GGTGATTAGATGAATC-1	T cells
GGTGATTAGGTAGGCT-1	Fibroblasts
GGTGATTAGGTCCCTG-1	T cells
GGTGATTAGTAGGATT-1	Monocytes
GGTGATTAGTATGAGT-1	Epithelial cells
GGTGATTCAATCAGCT-1	Epithelial cells
GGTGATTTCAGCAATC-1	T cells
GGTGGCTAGACCAGAC-1	NK cells
GGTGGCTAGCGGTATG-1	T cells
GGTGGCTCACTCCACT-1	NK cells
GGTGTCGAGAGTCAAT-1	Monocytes
GGTGTCGCAGGCGTTC-1	T cells
GGTGTCGTCAGCGGAA-1	T cells
GGTGTCGTCCATATGG-1	Macrophages
GGTGTCGTCGTTCTCG-1	T cells
GGTGTCGTCTCATTTG-1	Fibroblasts
GGTGTCGTCTTTCCAA-1	Epithelial cells
GGTGTTAAGGCATCTT-1	Epithelial cells
GGTGTTACAGTCAGTT-1	T cells
GGTGTTACATCGAAGG-1	T cells
GGTTAACAGCGACAGT-1	NK cells
GGTTAACGTACATTGC-1	Macrophages
GGTTAACTCCAGGACC-1	Macrophages
GGTTAACTCTCTATGT-1	Epithelial cells
GGTTCTCAGAGATCGC-1	T cells
GGTTCTCAGGTACAGC-1	T cells
GGTTCTCCATAGGAGC-1	Monocytes
GGTTCTCGTGTTCCAA-1	B cells
GGTTCTCTCATGAGGG-1	Fibroblasts
GGTTGTAAGCACGTCC-1	T cells
GGTTGTAAGGACACTG-1	T cells
GGTTGTAAGGGATCAC-1	NK cells
GGTTGTACAGTACTAC-1	Monocytes
GGTTGTAGTCGAGTGA-1	T cells
GGTTGTAGTTGCCAAT-1	DC
GGTTGTATCAACCTCC-1	Epithelial cells
GTAACACGTGGGCTCT-1	Epithelial cells
GTAACACTCTCTCTAA-1	T cells
GTAACCAGTACGCGTC-1	Monocytes
GTAACCATCCGCCTAT-1	T cells
GTAACCATCGAAATCC-1	Macrophages
GTAACCATCTCCAAGA-1	T cells
GTAAGTCCATCGGATT-1	NK cells
GTAAGTCGTACTCGAT-1	Macrophages
GTAAGTCTCCATTTGT-1	T cells
GTAAGTCTCTATACTC-1	T cells
GTAATCGAGCCATATC-1	NK cells
GTAATCGCACATTCTT-1	Epithelial cells
GTAATCGGTCAACCTA-1	NK cells
GTAATCGGTCTTGTCC-1	NK cells
GTAATCGGTTCCGTTC-1	NK cells
GTAATCGTCATCACCC-1	Epithelial cells
GTAATGCAGGCACTAG-1	Epithelial cells
GTAATGCAGTCGCCAC-1	Epithelial cells
GTAATGCAGTGTAGTA-1	T cells
GTAATGCGTCCAAAGG-1	B cells
GTAATGCTCACTGGTA-1	Macrophages
GTACAACAGCTCGGCT-1	T cells
GTACAACAGTAAATGC-1	T cells
GTACAACCATCATTTC-1	T cells
GTACAGTAGACATATG-1	T cells
GTACAGTAGTTCCGTA-1	Macrophages
GTACAGTCACAACGCC-1	pDC
GTACAGTGTTCGGGTC-1	T cells
GTACAGTGTTTCGCTC-1	T cells
GTAGAAACACACGGAA-1	T cells
GTAGAAACATCGGATT-1	B cells
GTAGAAAGTCAGGTAG-1	T cells
GTAGAGGAGCTAAGTA-1	Macrophages
GTAGAGGAGGCATCAG-1	NK cells
GTAGAGGAGGCTAACG-1	T cells
GTAGAGGAGGTGCCTC-1	T cells
GTAGAGGCAAGCAGGT-1	T cells
GTAGAGGCAATGTGGG-1	Epithelial cells
GTAGAGGGTGCTTCAA-1	Monocytes
GTAGATCAGTTACGGG-1	T cells
GTAGATCCAAACCACT-1	Monocytes
GTAGATCGTGTCATCA-1	DC
GTAGATCTCATTGCGA-1	Fibroblasts
GTAGCTAAGTTGTCGT-1	Epithelial cells
GTAGCTACACAGTCAT-1	T cells
GTAGCTAGTAGGACCA-1	pDC
GTAGCTAGTCGCTTGG-1	Epithelial cells
GTAGCTAGTGCAACAG-1	T cells
GTAGCTATCCCTCAAC-1	T cells
GTAGCTATCGCATTGA-1	Epithelial cells
GTAGGAGAGAGGGTGG-1	T cells
GTAGGAGAGTGGACTG-1	B cells
GTAGGAGGTAGGGTAC-1	T cells
GTAGGAGGTCTTAGTG-1	Epithelial cells
GTAGGAGGTTCAACGT-1	Epithelial cells
GTAGGAGTCACCGCTT-1	DC
GTAGGAGTCGATACGT-1	Macrophages
GTAGGTTAGATGTTAG-1	Macrophages
GTAGGTTCAAGATTGA-1	Epithelial cells
GTAGGTTCACACCTTC-1	T cells
GTAGGTTCAGGCATTT-1	Epithelial cells
GTAGGTTCATAGCTGT-1	B cells
GTAGGTTCATGGTACT-1	Monocytes
GTAGGTTGTAGTGGCA-1	T cells
GTAGGTTGTCTTGCTC-1	B cells
GTAGGTTGTGTGAATA-1	T cells
GTAGGTTGTTTGCAGT-1	Epithelial cells
GTAGGTTTCAAGGTGG-1	T cells
GTAGGTTTCGTTGTGA-1	T cells
GTAGTACAGCATGATA-1	T cells
GTAGTACAGCGTCTCG-1	Macrophages
GTAGTACAGTCATTGC-1	T cells
GTAGTACCACATGGTT-1	T cells
GTAGTACCAGGGCTTC-1	T cells
GTAGTACGTATGAGAT-1	Macrophages
GTAGTACGTCATCCGG-1	T cells
GTAGTACTCATCAGTG-1	T cells
GTAGTACTCGGACAAG-1	T cells
GTATTGGAGCCATTTG-1	Epithelial cells
GTATTGGCAAATGCTC-1	Epithelial cells
GTATTGGCAACCGTAT-1	T cells
GTATTGGCAGTTCACA-1	T cells
GTATTGGCATGTTACG-1	pDC
GTATTGGGTAAGGCCA-1	Plasma cells
GTATTGGGTGGAACAC-1	Macrophages
GTATTTCAGAGAAGGT-1	Macrophages
GTATTTCAGCTAAACA-1	NK cells
GTATTTCGTGAGATAT-1	Macrophages
GTATTTCTCACATCAG-1	Epithelial cells
GTATTTCTCACTCACC-1	T cells
GTATTTCTCTAACGCA-1	Macrophages
GTCAAACGTCATCCGG-1	T cells
GTCAAACTCCATCAGA-1	B cells
GTCAAGTGTAATGTGA-1	Epithelial cells
GTCAAGTGTATCCCTC-1	T cells
GTCAAGTGTCGCGTTG-1	T cells
GTCACGGAGCTCTTCC-1	T cells
GTCACGGCAGCTGTCG-1	T cells
GTCACGGTCCCTTGGT-1	T cells
GTCACTCAGATGCAGC-1	T cells
GTCACTCCAACACACT-1	T cells
GTCACTCCAGCTGTAT-1	T cells
GTCACTCCATCGCCTT-1	Macrophages
GTCACTCGTATTCCGA-1	Epithelial cells
GTCAGCGCAATGAAAC-1	T cells
GTCAGCGCACGTCGGT-1	T cells
GTCAGCGCACTGTCCT-1	T cells
GTCAGCGCATGGATCT-1	T cells
GTCAGCGGTACTGTTG-1	Macrophages
GTCAGCGGTAGTTACC-1	T cells
GTCAGCGTCTGTCAGA-1	Epithelial cells
GTCATCCCATACCATG-1	Epithelial cells
GTCATCCGTATACGGG-1	T cells
GTCATCCGTCCAATCA-1	T cells
GTCATGAAGTTGAAAC-1	Epithelial cells
GTCATGACAATCGCGC-1	Epithelial cells
GTCATGACATTATGCG-1	Macrophages
GTCATGATCAAGTTGC-1	T cells
GTCATTTAGCCATTCA-1	T cells
GTCATTTCAGCACACC-1	T cells
GTCATTTCATTGAGGG-1	T cells
GTCATTTGTCACATTG-1	T cells
GTCATTTGTTTCTTAC-1	DC
GTCATTTTCCAACTGA-1	T cells
GTCCACTAGTTGAAAC-1	Fibroblasts
GTCCACTCAGGTTCCG-1	T cells
GTCCACTTCAGTCTTT-1	Epithelial cells
GTCCACTTCATCTACT-1	Endothelial cells
GTCCACTTCCGGGACT-1	Epithelial cells
GTCCACTTCTGAGAGG-1	T cells
GTCCCATAGTTCGCAT-1	T cells
GTCCCATGTGTTCATG-1	T cells
GTCCCATTCCTAGCCT-1	T cells
GTCCTCAAGTTCACTG-1	T cells
GTCCTCACAGCGCGTT-1	T cells
GTCCTCAGTAGGAGGG-1	T cells
GTCCTCAGTAGGTTTC-1	Macrophages
GTCCTCAGTGTCGCTG-1	T cells
GTCCTCATCGAGATAA-1	Endothelial cells
GTCCTCATCGGTCATA-1	T cells
GTCCTCATCTTTGATC-1	T cells
GTCGAATAGTCCCTAA-1	T cells
GTCGAATCACTAGAGG-1	T cells
GTCGAATCAGTAGATA-1	Epithelial cells
GTCGAATCAGTTTCAG-1	Monocytes
GTCGAATTCGCAGTTA-1	Epithelial cells
GTCGAATTCGGCTTGG-1	Epithelial cells
GTCGCGAAGATACGAT-1	T cells
GTCGCGACACTCAGAT-1	T cells
GTCGCGACACTTGAAC-1	T cells
GTCGCGACATGCCGCA-1	T cells
GTCGCGATCATCGCCT-1	T cells
GTCGCGATCTGGACCG-1	Plasma cells
GTCGTAAAGAACTTCC-1	T cells
GTCGTAAAGGACCCAA-1	NK cells
GTCGTAACATGCGTGC-1	T cells
GTCGTTCCATCGGTTA-1	T cells
GTCGTTCGTACCGGAA-1	pDC
GTCGTTCGTACGTAGG-1	Macrophages
GTCGTTCGTCAAAGTA-1	T cells
GTCGTTCGTCATCACA-1	Epithelial cells
GTCGTTCGTTGCTCAA-1	T cells
GTCGTTCTCTAGTCAG-1	T cells
GTCTACCAGCTGGTGA-1	pDC
GTCTACCTCACTTCTA-1	T cells
GTCTACCTCATGCAGT-1	T cells
GTCTACCTCCAGCAAT-1	Macrophages
GTCTACCTCTGCGAGC-1	T cells
GTCTAGACACCTGATA-1	T cells
GTCTAGAGTAAGCGGT-1	T cells
GTCTAGAGTACAGAAT-1	T cells
GTCTAGAGTCCAGCGT-1	Macrophages
GTCTAGAGTTCATCTT-1	B cells
GTCTAGATCACCTCAC-1	T cells
GTCTAGATCCCGATCT-1	T cells
GTCTAGATCTGTCGCT-1	T cells
GTCTCACAGAACCCGA-1	T cells
GTCTCACCAGACTCTA-1	T cells
GTCTCACGTAGGATAT-1	Epithelial cells
GTCTCACGTAGTATAG-1	T cells
GTCTCACGTCGGCACT-1	T cells
GTCTCACTCACCATCC-1	T cells
GTCTGTCAGCGTACAG-1	Endothelial cells
GTCTGTCAGGCAGGGA-1	Epithelial cells
GTCTGTCAGTAACGAT-1	B cells
GTCTGTCAGTGGAAAG-1	T cells
GTCTGTCCAAATGAGT-1	Monocytes
GTCTGTCCAATTGAAG-1	DC
GTCTGTCCACAGAGCA-1	T cells
GTCTGTCTCACTCGAA-1	Epithelial cells
GTCTGTCTCGATTTCT-1	T cells
GTCTTTAAGACGCTCC-1	Epithelial cells
GTCTTTAAGCGCCGTT-1	NK cells
GTCTTTAAGGGTGGGA-1	DC
GTCTTTACACCAGGTC-1	T cells
GTCTTTACACGTACAT-1	T cells
GTCTTTAGTACAAGTA-1	T cells
GTCTTTATCAAGAAAC-1	NK cells
GTCTTTATCGTGCAGC-1	T cells
GTGACGCAGACCGCCT-1	Macrophages
GTGACGCGTAGGGTAC-1	NK cells
GTGACGCGTGCACGCT-1	Epithelial cells
GTGACGCGTGGACTGA-1	T cells
GTGACGCTCACTGCTC-1	T cells
GTGACGCTCCGTGTAA-1	Epithelial cells
GTGAGCCCAAACTAAG-1	Epithelial cells
GTGAGCCCAACTCGAT-1	Epithelial cells
GTGAGCCCAAGGAGTC-1	T cells
GTGAGCCCATCGCTGG-1	Fibroblasts
GTGAGCCGTTAAACAG-1	Epithelial cells
GTGAGCCTCCGTACGG-1	T cells
GTGAGGAAGGCAGGGA-1	Macrophages
GTGAGGAAGTACAACA-1	Macrophages
GTGAGGAAGTCGCGAA-1	Endothelial cells
GTGAGGACAGACCTGC-1	DC
GTGAGGAGTAGTCTGT-1	B cells
GTGAGGAGTTAGGGTG-1	T cells
GTGAGGATCGTTCATT-1	Fibroblasts
GTGAGTTAGAAGTGTT-1	T cells
GTGAGTTCAGCTGGTC-1	Monocytes
GTGATGTAGGCATGGT-1	T cells
GTGATGTAGGTGCCAA-1	T cells
GTGATGTGTGGAGGTT-1	T cells
GTGATGTGTGTCCCTT-1	T cells
GTGCACGAGGCACAAC-1	Epithelial cells
GTGCACGAGTCTGCGC-1	Epithelial cells
GTGCACGCATGCCGGT-1	Epithelial cells
GTGCACGGTATCACGT-1	T cells
GTGCAGCAGTACGAGC-1	Macrophages
GTGCAGCAGTATGGAT-1	NK cells
GTGCAGCAGTCTGCGC-1	Epithelial cells
GTGCAGCGTACCTAGT-1	Epithelial cells
GTGCAGCGTACTAGCT-1	Epithelial cells
GTGCGTGAGCTGACCC-1	T cells
GTGCGTGGTCAAGTTC-1	Macrophages
GTGCGTGTCCGACAGC-1	B cells
GTGCTGGAGCACCGTC-1	T cells
GTGCTGGCAGACGGAT-1	T cells
GTGCTGGCATAGTCAC-1	T cells
GTGCTGGGTATTTCTC-1	Epithelial cells
GTGCTGGGTCTCGACG-1	T cells
GTGCTTCGTTATAGCC-1	T cells
GTGCTTCTCCGAGAAG-1	pDC
GTGCTTCTCTATGTGG-1	T cells
GTGGAAGAGAGTCTTC-1	Epithelial cells
GTGGAAGCACTCATAG-1	Epithelial cells
GTGGAAGTCCCAGGAC-1	T cells
GTGGAAGTCGCACGGT-1	Macrophages
GTGGAGACAACGCATT-1	T cells
GTGGAGACACACGGAA-1	Epithelial cells
GTGGAGACACTGAGGA-1	T cells
GTGGAGATCCTTGACC-1	Macrophages
GTGGAGATCTGCTAGA-1	T cells
GTGGCGTAGGGCGAAG-1	NK cells
GTGGCGTCACCCTAAA-1	T cells
GTGGCGTGTGAACGGT-1	T cells
GTGGCGTTCGTAGGAG-1	T cells
GTGGCGTTCTCCGATC-1	Macrophages
GTGGGAACAACCTATG-1	pDC
GTGGGAAGTCCTACAA-1	T cells
GTGGTTAAGAAGGTAG-1	T cells
GTGGTTAAGTGCGTCC-1	NK cells
GTGGTTAAGTTCATCG-1	Monocytes
GTGGTTAGTACTGGGA-1	T cells
GTGTAACAGAGTGAAG-1	T cells
GTGTAACAGGATGTTA-1	Epithelial cells
GTGTCCTAGCACACCC-1	T cells
GTGTCCTAGGTACAAT-1	Epithelial cells
GTGTCCTCACCGCTGA-1	Epithelial cells
GTGTCCTGTGGATCGA-1	T cells
GTGTCCTGTGTCTAAC-1	Macrophages
GTGTCCTTCATCTCTA-1	T cells
GTGTGATAGTGGATTA-1	Epithelial cells
GTGTGATGTCTAGTGT-1	T cells
GTGTGATGTTCAAACC-1	NK cells
GTGTGATGTTCCTACC-1	Epithelial cells
GTGTGATTCGTCGATA-1	Epithelial cells
GTGTGATTCTTTCTAG-1	NK cells
GTGTGGCCACCCTATC-1	T cells
GTGTGGCCATGTTCGA-1	Epithelial cells
GTGTGGCGTCATAAAG-1	T cells
GTGTGGCGTGGCAGAT-1	Fibroblasts
GTGTGGCGTTCCACAA-1	Epithelial cells
GTGTTAGAGAACTTCC-1	Monocytes
GTGTTAGAGCTTTGTG-1	T cells
GTGTTAGCAGTCAACT-1	Endothelial cells
GTGTTAGGTGTAACGG-1	T cells
GTGTTAGTCCGTTGAA-1	NK cells
GTGTTAGTCGGAATTC-1	Fibroblasts
GTGTTCCCAGGTGAGT-1	DC
GTGTTCCTCTACCTTA-1	Macrophages
GTTACAGAGACATAAC-1	Fibroblasts
GTTACAGCACCTGCTT-1	NK cells
GTTACAGCATGACTCA-1	DC
GTTACAGGTATACCCA-1	T cells
GTTACAGGTGGGCTCT-1	T cells
GTTACAGTCCCTCAAC-1	T cells
GTTACAGTCCGCACGA-1	T cells
GTTACAGTCCGTGACG-1	Macrophages
GTTACAGTCTCGACCT-1	T cells
GTTACCCAGAAGTCCG-1	Macrophages
GTTACCCAGAGTTGCG-1	T cells
GTTACCCCACAGTACT-1	T cells
GTTACCCCACTACAGT-1	T cells
GTTACCCCATGTTCGA-1	T cells
GTTACCCTCACGGAGA-1	T cells
GTTACCCTCTTAGCAG-1	T cells
GTTACGAAGAACAAGG-1	DC
GTTACGAAGCACGTCC-1	Epithelial cells
GTTACGACACACTTAG-1	Monocytes
GTTACGACAGTTTCAG-1	B cells
GTTACGATCACATCAG-1	T cells
GTTACGATCCGCTTAC-1	Epithelial cells
GTTACGATCTGGAGAG-1	NK cells
GTTAGACAGACGCCAA-1	Epithelial cells
GTTAGACCACGAAAGC-1	B cells
GTTAGACTCCGAAATC-1	Epithelial cells
GTTAGTGAGCCTAGGA-1	T cells
GTTAGTGAGCCTGTGC-1	T cells
GTTAGTGCAATTTCTC-1	DC
GTTAGTGCACGACAGA-1	T cells
GTTAGTGCATGGTGGA-1	NK cells
GTTAGTGGTAGAAACT-1	T cells
GTTAGTGGTCAGTCTA-1	T cells
GTTAGTGGTTCTGAGT-1	T cells
GTTATGGCACTGAGGA-1	T cells
GTTATGGTCCGTACGG-1	T cells
GTTATGGTCTAAGCGT-1	T cells
GTTATGGTCTCCACTG-1	NK cells
GTTATGGTCTCTGCCA-1	NK cells
GTTATGGTCTTGATTC-1	T cells
GTTATGGTCTTTGCAT-1	Fibroblasts
GTTCATTAGCTGCGAA-1	T cells
GTTCATTCAAGCCCAC-1	T cells
GTTCATTCATAGAGGC-1	T cells
GTTCATTGTAGTCACT-1	T cells
GTTCATTGTCATAACC-1	Epithelial cells
GTTCATTGTCGCGTTG-1	T cells
GTTCATTTCGAGCTGC-1	T cells
GTTCATTTCTCTGCTG-1	Monocytes
GTTCCGTAGTCTCTGA-1	NK cells
GTTCCGTCAAGAGGTC-1	Macrophages
GTTCCGTCACGATTCA-1	Epithelial cells
GTTCCGTCAGCTTTGA-1	Macrophages
GTTCCGTGTACCACGC-1	B cells
GTTCCGTGTACGATGG-1	T cells
GTTCCGTTCCAAGCAT-1	T cells
GTTCGCTAGGGCCCTT-1	T cells
GTTCGCTGTAACATGA-1	T cells
GTTCGCTGTCACAGAG-1	T cells
GTTCGCTTCGCCGAAC-1	T cells
GTTCGCTTCTCTCGCA-1	T cells
GTTCGCTTCTTGGTCC-1	T cells
GTTCTATAGGATACAT-1	Macrophages
GTTCTATAGGGACTGT-1	T cells
GTTCTATTCCGTGGGT-1	NK cells
GTTCTATTCTCGGGAC-1	T cells
GTTGAACAGCACTGGA-1	T cells
GTTGAACCAAAGGGCT-1	T cells
GTTGAACTCAAACCCA-1	B cells
GTTGAACTCACGACTA-1	Epithelial cells
GTTGAACTCTGGAGAG-1	Epithelial cells
GTTGCGGAGGATGCGT-1	Epithelial cells
GTTGCGGCAGAACCGA-1	Epithelial cells
GTTGCGGGTGTTACAC-1	Endothelial cells
GTTGCTCAGACCTCCG-1	T cells
GTTGCTCAGGTGCGAT-1	Epithelial cells
GTTGCTCCAGTTTCAG-1	Epithelial cells
GTTGCTCGTACTGTTG-1	B cells
GTTGCTCGTGTCCGGT-1	T cells
GTTGCTCTCCTGGGTG-1	T cells
GTTGCTCTCTGATTCT-1	T cells
GTTGTAGAGATTGGGC-1	T cells
GTTGTAGCAAGGTTGG-1	Epithelial cells
GTTGTAGCACATGTTG-1	B cells
GTTGTAGCATTGGGAG-1	Epithelial cells
GTTGTAGGTAATCAAG-1	T cells
GTTGTAGGTGGAAGTC-1	Monocytes
GTTGTAGTCCCGAACG-1	T cells
GTTGTCCAGACCTGGA-1	T cells
GTTGTCCCAAGCACCC-1	T cells
GTTGTCCGTGTTCCAA-1	Macrophages
GTTGTGAAGGCTTTCA-1	T cells
GTTGTGAAGTGATAGT-1	T cells
GTTGTGACACCGCTAG-1	T cells
GTTGTGACATGATCTG-1	NK cells
GTTGTGAGTGGCCACT-1	Epithelial cells
GTTGTGAGTGGCTTAT-1	T cells
GTTGTGATCAGTGTTG-1	T cells
GTTGTGATCATAGGCT-1	Fibroblasts
GTTGTGATCTGAGTCA-1	Macrophages
GTTTACTAGAGGGTGG-1	T cells
GTTTACTAGTATAACG-1	Macrophages
GTTTACTAGTTCCGGC-1	T cells
GTTTACTCACTCAAGT-1	T cells
GTTTACTTCGTGGAAG-1	Epithelial cells
GTTTGGAAGACGGTTG-1	Monocytes
GTTTGGAAGAGAAGGT-1	Epithelial cells
GTTTGGAAGCAGGGAG-1	DC
GTTTGGAAGGTCGTAG-1	NK cells
GTTTGGATCCACATAG-1	T cells
GTTTGGATCGACCATA-1	T cells
TAACACGCAGCGACCT-1	B cells
TAACACGCAGGAGACT-1	Epithelial cells
TAACACGGTCCGGCAT-1	Epithelial cells
TAACACGGTCGTTCAA-1	T cells
TAACACGTCAAGATAG-1	Epithelial cells
TAACACGTCCTCTTTC-1	T cells
TAACCAGAGCACCTGC-1	T cells
TAACCAGCACCTCGTT-1	NK cells
TAACCAGCAGACCTGC-1	Macrophages
TAACCAGCAGCGTAGA-1	T cells
TAACCAGCATAGAATG-1	T cells
TAACCAGCATAGCACT-1	T cells
TAACCAGCATGTGCCG-1	Epithelial cells
TAACCAGGTATCGGTT-1	T cells
TAACCAGGTGGCTTGC-1	Macrophages
TAACCAGTCAACGTGT-1	Epithelial cells
TAACCAGTCTACACAG-1	Epithelial cells
TAACGACAGGCCTAAG-1	Epithelial cells
TAACGACAGTTCACTG-1	T cells
TAACGACGTCGGATTT-1	T cells
TAACGACTCACCTGGG-1	Macrophages
TAACGACTCGCCAGTG-1	T cells
TAACTTCCAGCGACCT-1	Macrophages
TAACTTCGTGACGCCT-1	T cells
TAAGCACAGAGAACCC-1	Macrophages
TAAGCACCAGACCATT-1	T cells
TAAGCACGTCGTAATC-1	T cells
TAAGCACGTGAGGAAA-1	Epithelial cells
TAAGCACGTGCGGTAA-1	Epithelial cells
TAAGCCAAGACAACAT-1	T cells
TAAGCCAAGTGCGTCC-1	T cells
TAAGCGTAGCATGAAT-1	Epithelial cells
TAAGCGTAGCTCTGTA-1	NK cells
TAAGCGTAGTACCGGA-1	pDC
TAAGCGTGTCCCGGTA-1	T cells
TAAGTCGAGTCTAACC-1	Monocytes
TAAGTCGCAGAGTCTT-1	T cells
TAAGTCGCAGTCTTCC-1	T cells
TAAGTCGCATCCTCAC-1	B cells
TAAGTCGCATGTGCTA-1	Epithelial cells
TAAGTCGGTGGCTACC-1	T cells
TAAGTCGGTTCTATCT-1	T cells
TAATCTCCACATGAAA-1	T cells
TAATCTCTCATGCTAG-1	T cells
TAATTCCAGGCTGAAC-1	T cells
TAATTCCAGTATCTGC-1	T cells
TAATTCCGTAGCACGA-1	Epithelial cells
TAATTCCGTCCACTTC-1	NK cells
TAATTCCGTGCGGCTT-1	Epithelial cells
TAATTCCGTGGCTTAT-1	Macrophages
TAATTCCTCATCACAG-1	Epithelial cells
TAATTCCTCTCCTACG-1	NK cells
TACAACGAGCTGCCTG-1	B cells
TACAACGAGTCTTCCC-1	T cells
TACAACGCAACAAAGT-1	Epithelial cells
TACAACGCAACCAGAG-1	Macrophages
TACAACGGTTTGACAC-1	Mast cells
TACACCCAGCACGGAT-1	Epithelial cells
TACACCCAGCCTGACC-1	T cells
TACACCCAGGCCTGCT-1	T cells
TACACCCCAATGGCCC-1	T cells
TACACCCGTCACGTGC-1	T cells
TACAGGTAGACATCCT-1	T cells
TACAGGTTCCTACAAG-1	Epithelial cells
TACATTCAGATACATG-1	pDC
TACATTCAGCTGACTT-1	T cells
TACATTCCAACAGATA-1	T cells
TACATTCCATACGCAT-1	T cells
TACATTCTCACGACTA-1	Fibroblasts
TACCCACAGTTACTCG-1	T cells
TACCCACGTGAACGGT-1	T cells
TACCCACGTGTCCTAA-1	T cells
TACCCACTCCGAAGGA-1	Monocytes
TACCCACTCTCATTTG-1	T cells
TACCCGTAGAACGTGC-1	T cells
TACCCGTCATGATAGA-1	Epithelial cells
TACCCGTGTCCTACGG-1	T cells
TACCCGTTCCATACTT-1	T cells
TACCCGTTCTCCACTG-1	T cells
TACCGAAAGATAGCAT-1	T cells
TACCGAACAAAGCAAT-1	NK cells
TACCGAACAAATCGTC-1	Epithelial cells
TACCGAATCAGGAACG-1	T cells
TACCGAATCATAGAGA-1	Macrophages
TACCGAATCCAACACA-1	T cells
TACCGAATCTTTCTAG-1	T cells
TACCGGGGTAGCTGTT-1	Monocytes
TACCGGGGTCAGCTTA-1	T cells
TACCGGGTCACCCATC-1	NK cells
TACCGGGTCGTTGTAG-1	T cells
TACCTCGCAGAAGCGT-1	Epithelial cells
TACCTCGGTAAGAACT-1	Monocytes
TACCTCGGTCTCGCGA-1	NK cells
TACCTGCAGCGGTATG-1	Epithelial cells
TACCTGCAGCGTTCCG-1	T cells
TACCTGCCAGTAGAAT-1	T cells
TACCTGCCATAGTCGT-1	Epithelial cells
TACCTGCCATGGATCT-1	T cells
TACCTGCCATTCTCCG-1	T cells
TACCTGCGTGAATATG-1	T cells
TACCTGCTCCGCATAA-1	Epithelial cells
TACCTGCTCGATGCTA-1	Monocytes
TACGCTCAGTATCCTG-1	Macrophages
TACGCTCCACCGTGAC-1	NK cells
TACGCTCTCCAGCACG-1	pDC
TACGGGCAGAGATCGC-1	T cells
TACGGGCTCATAGAGA-1	T cells
TACGGGCTCGGATTAC-1	Epithelial cells
TACGGTAAGCCGAATG-1	T cells
TACGGTAAGGTCTACT-1	Epithelial cells
TACGGTACACTTACAG-1	Macrophages
TACGGTAGTACAGCGA-1	Epithelial cells
TACGGTATCGAGATAA-1	T cells
TACGGTATCGATTCCC-1	NK cells
TACGGTATCTTCTAAC-1	T cells
TACGTCCTCTCAGAAC-1	Macrophages
TACTGCCAGGTCCGAA-1	T cells
TACTGCCTCGTTCCTG-1	Macrophages
TACTGCCTCTCTGGTC-1	DC
TACTTACAGGTGCGAT-1	Fibroblasts
TACTTACCAATTCTTC-1	T cells
TACTTACCATCCCACT-1	Epithelial cells
TACTTACCATTGTACG-1	T cells
TACTTACGTACCATAC-1	DC
TACTTACGTGAGTAGC-1	T cells
TACTTACTCCGCTAGG-1	T cells
TACTTCAAGAAGTATC-1	T cells
TACTTCAAGACTACCT-1	Monocytes
TACTTCAGTCGTGGAA-1	T cells
TACTTCAGTTACCTGA-1	Epithelial cells
TACTTCATCATGGTAC-1	T cells
TACTTGTAGAGAGAAC-1	T cells
TACTTGTAGATGGTAT-1	Monocytes
TACTTGTCAAACCGGA-1	Macrophages
TACTTGTGTCATATGC-1	T cells
TACTTGTGTCTTTCTA-1	T cells
TACTTGTGTTCTCTCG-1	Epithelial cells
TAGACCACAGCGACCT-1	NK cells
TAGACCACAGTCAGCC-1	T cells
TAGACCAGTTCCGTTC-1	T cells
TAGACCATCGGATAAA-1	Macrophages
TAGACTGAGATTCGCT-1	T cells
TAGACTGAGCTGAAGC-1	T cells
TAGACTGCAGCACAGA-1	T cells
TAGACTGGTGTATTCG-1	Epithelial cells
TAGACTGTCATTTACC-1	Epithelial cells
TAGACTGTCGATACGT-1	Monocytes
TAGACTGTCTTGATTC-1	T cells
TAGAGTCAGGTCCCTG-1	T cells
TAGAGTCAGTCAATCC-1	NK cells
TAGAGTCCAACCGGAA-1	T cells
TAGAGTCCATACATCG-1	Monocytes
TAGAGTCGTGAGATAT-1	T cells
TAGAGTCTCAAGTTGC-1	T cells
TAGAGTCTCGAACCAT-1	T cells
TAGAGTCTCTAGGAAA-1	T cells
TAGATCGAGCTGACAG-1	T cells
TAGATCGGTTAGGGTG-1	T cells
TAGATCGTCTTAATCC-1	B cells
TAGCACACAAATAAGC-1	Epithelial cells
TAGCACACAGCGGTCT-1	Macrophages
TAGCACAGTGCCTACG-1	Macrophages
TAGCACAGTTACTCAG-1	T cells
TAGGAGGAGAAGTGTT-1	T cells
TAGGAGGAGCACTCAT-1	pDC
TAGGAGGAGGAACGCT-1	Epithelial cells
TAGGAGGAGTATAACG-1	pDC
TAGGAGGAGTGGTGGT-1	T cells
TAGGAGGCAAACTAGA-1	Macrophages
TAGGAGGCAAGTATAG-1	DC
TAGGAGGTCATATGGC-1	T cells
TAGGAGGTCCGTATGA-1	T cells
TAGGGTTAGCTCCGAC-1	B cells
TAGGGTTCAGCATGCC-1	T cells
TAGGGTTCATGGCCAC-1	Monocytes
TAGGGTTTCGACGAGA-1	Epithelial cells
TAGGTACAGAGTTGAT-1	T cells
TAGGTACAGATTGGGC-1	Epithelial cells
TAGGTACCAGCTCGGT-1	Fibroblasts
TAGGTACGTACTCCCT-1	T cells
TAGGTACGTATAGGGC-1	T cells
TAGGTACGTGCGTGCT-1	T cells
TAGGTACTCTCAGTCC-1	T cells
TAGGTTGAGGATACAT-1	Macrophages
TAGGTTGAGTCACTGT-1	Epithelial cells
TAGGTTGAGTTGTAAG-1	Epithelial cells
TAGGTTGCACAGCATT-1	NK cells
TAGGTTGCATTCAGGT-1	T cells
TAGGTTGGTGCACGCT-1	T cells
TAGGTTGTCAAGAATG-1	T cells
TAGTGCAAGCATCAGG-1	T cells
TAGTGCAAGTACTGGG-1	Macrophages
TAGTGCACAGAAATCA-1	T cells
TAGTGCACAGCGATTT-1	Epithelial cells
TAGTGCACATACTTTC-1	T cells
TAGTGCAGTAGGTGCA-1	T cells
TAGTGCATCGCGAAGA-1	T cells
TAGTGCATCGTTGTGA-1	T cells
TAGTGCATCTGAGTCA-1	T cells
TAGTGCATCTTCTCAA-1	Macrophages
TATACCTAGATAGTGT-1	Endothelial cells
TATACCTCATCTGGGC-1	T cells
TATACCTGTTACACAC-1	NK cells
TATACCTTCCTTGGAA-1	T cells
TATACCTTCGACGAGA-1	T cells
TATACCTTCTACCAGA-1	T cells
TATATCCAGACCAGAC-1	Epithelial cells
TATATCCAGGGCAATC-1	T cells
TATATCCGTAGTGCGA-1	Macrophages
TATATCCGTTCCTAGA-1	T cells
TATATCCTCACTGGTA-1	Monocytes
TATATCCTCAGCTGAT-1	T cells
TATCAGGAGACTGGGT-1	T cells
TATCAGGAGCGCCCAT-1	Epithelial cells
TATCAGGAGGCATCTT-1	Epithelial cells
TATCAGGGTAGCTAAA-1	T cells
TATCAGGTCACATTGG-1	T cells
TATCAGGTCACTACGA-1	Epithelial cells
TATCCTACAATCCAGT-1	T cells
TATCCTACACAAACGG-1	NK cells
TATCCTAGTACAAAGT-1	T cells
TATCCTAGTTGAGGAC-1	T cells
TATCCTATCTGAGATC-1	T cells
TATCCTATCTTGATTC-1	T cells
TATCGCCAGAATCTAG-1	Macrophages
TATCGCCAGGTAACTA-1	T cells
TATCGCCAGTCACTCA-1	DC
TATCGCCCACAGGATG-1	Macrophages
TATCGCCCAGAGCTAG-1	T cells
TATCGCCGTATGTGTC-1	pDC
TATCGCCGTCTTGAAC-1	T cells
TATCTGTAGCCTCTTC-1	T cells
TATCTGTCACGGTGTC-1	T cells
TATCTGTCAGGTCAAG-1	T cells
TATCTGTCATCGGAGA-1	T cells
TATCTGTGTCATAACC-1	T cells
TATCTGTGTGGAATGC-1	T cells
TATCTGTGTTCACCGG-1	DC
TATCTGTTCAGAGCAG-1	Macrophages
TATCTGTTCCATAGGT-1	T cells
TATCTTGAGCTACAAA-1	Epithelial cells
TATCTTGGTGCATCTA-1	T cells
TATCTTGTCAGGGTAG-1	T cells
TATCTTGTCGGTCTAA-1	Fibroblasts
TATGTTCAGTATTCCG-1	Endothelial cells
TATGTTCCATGTGCTA-1	NK cells
TATGTTCGTACTAAGA-1	T cells
TATGTTCGTAGTCACT-1	Epithelial cells
TATGTTCTCCCGATCT-1	T cells
TATTCCACAGTCAACT-1	T cells
TATTCCAGTATGTCCA-1	T cells
TATTCCAGTCGTATGT-1	T cells
TATTCCATCGTTCCTG-1	T cells
TATTGCTAGAATCGAT-1	Endothelial cells
TATTGCTAGCCGTTGC-1	T cells
TATTGCTCACGACTAT-1	Endothelial cells
TATTGCTTCAGCCCAG-1	Epithelial cells
TATTGCTTCGCGCTGA-1	T cells
TATTGGGAGGGAGGAC-1	T cells
TATTGGGCAAACTAAG-1	T cells
TATTGGGCATGACTTG-1	Epithelial cells
TATTGGGCATTGAGGG-1	T cells
TATTGGGGTTCTCTCG-1	T cells
TATTGGGTCATTTACC-1	NK cells
TATTGGGTCGTTCATT-1	Macrophages
TATTGGGTCGTTGTAG-1	Epithelial cells
TATTGGGTCTCCGAGG-1	Epithelial cells
TATTGGGTCTCGCTCA-1	T cells
TATTGGGTCTTGTGCC-1	B cells
TATTTCGAGACTTCGT-1	T cells
TATTTCGAGCCAGACA-1	B cells
TATTTCGAGGAATCGC-1	T cells
TATTTCGGTGCCAAGA-1	Macrophages
TATTTCGGTGGAGAAA-1	Epithelial cells
TATTTCGGTTCAGTAC-1	B cells
TATTTCGTCCGACGGT-1	T cells
TATTTCGTCCTGGGTG-1	T cells
TATTTCGTCTGCCCTA-1	DC
TCAAGACTCACTGTCC-1	Macrophages
TCAAGACTCATGGTAC-1	T cells
TCAAGCAAGAAATGGG-1	Epithelial cells
TCAAGCACAGTCTACA-1	DC
TCAAGCACATAGCACT-1	DC
TCAAGCACATGCCGCA-1	T cells
TCAAGCAGTACAATAG-1	T cells
TCAAGCATCCAGGACC-1	Epithelial cells
TCAAGTGAGCGATGAC-1	T cells
TCAAGTGAGTCGTCTA-1	Epithelial cells
TCAAGTGCAAAGTGTA-1	T cells
TCAAGTGGTTATAGAG-1	Endothelial cells
TCAAGTGTCACCTCAC-1	T cells
TCAAGTGTCCGACAGC-1	T cells
TCAAGTGTCGGTCTGG-1	T cells
TCAATCTAGTTTCAGC-1	T cells
TCAATCTCAACTCATG-1	T cells
TCAATCTGTCTCACAA-1	B cells
TCAATCTGTGATAGTA-1	NK cells
TCAATTCAGGACAAGA-1	T cells
TCAATTCCAAGGGCAT-1	B cells
TCAATTCCAGCGAGTA-1	Epithelial cells
TCAATTCGTGCACATT-1	T cells
TCAATTCTCTGGCTGG-1	T cells
TCAATTCTCTGTGCTC-1	B cells
TCACAAGAGACTCTAC-1	Epithelial cells
TCACAAGAGAGTGTGC-1	Macrophages
TCACAAGAGCCTGACC-1	T cells
TCACAAGAGGAGAGGC-1	Monocytes
TCACAAGAGGTATAGT-1	T cells
TCACAAGAGTCTGCAT-1	T cells
TCACAAGCATCCTTCG-1	Epithelial cells
TCACAAGTCGGTCACG-1	Macrophages
TCACACCGTAGGTGCA-1	T cells
TCACACCTCCGGTTCT-1	T cells
TCACACCTCCGTACGG-1	T cells
TCACACCTCGTAACAC-1	NK cells
TCACATTCAATGTCAC-1	Macrophages
TCACATTCACGACCTG-1	T cells
TCACATTCATGGATCT-1	Endothelial cells
TCACATTGTACAGCGA-1	T cells
TCACATTGTACTAAGA-1	Epithelial cells
TCACATTTCGCCGAAC-1	T cells
TCACGCTCAAGTTCCA-1	T cells
TCACGCTGTCAAAGCG-1	T cells
TCACGCTTCGCACGAC-1	pDC
TCACGGGTCAGCCCAG-1	T cells
TCACGGGTCAGCGGAA-1	T cells
TCACGGGTCATCGTAG-1	pDC
TCACTATCAGTCAACT-1	Epithelial cells
TCACTATGTATGAAGT-1	Epithelial cells
TCACTCGAGCCAAGGT-1	T cells
TCACTCGAGCCGAATG-1	Epithelial cells
TCACTCGCAACGATCT-1	T cells
TCACTCGCACGCTGTG-1	T cells
TCACTCGCACTGAGTT-1	T cells
TCACTCGGTATAATGG-1	T cells
TCACTCGGTCAAGGCA-1	T cells
TCACTCGGTTTCGACA-1	DC
TCACTCGTCCGGGACT-1	Macrophages
TCACTCGTCCTCTTTC-1	T cells
TCAGCAAAGTAAAGCT-1	T cells
TCAGCAAGTGTCTTCC-1	Macrophages
TCAGCAAGTTACAGCT-1	T cells
TCAGCAATCTCCTGAC-1	Epithelial cells
TCAGCCTAGGCATCTT-1	DC
TCAGCCTCACTTACAG-1	Epithelial cells
TCAGCCTCATCGATCA-1	NK cells
TCAGCCTTCAGAGTTC-1	T cells
TCAGGGCAGAATTCAG-1	Epithelial cells
TCAGGGCAGGCTCTCG-1	NK cells
TCAGGGCAGGTTCCAT-1	Epithelial cells
TCAGGGCCAATATCCG-1	B cells
TCAGGGCCAGACGATG-1	T cells
TCAGGGCCAGCACAGA-1	B cells
TCAGGGCGTTACGATC-1	T cells
TCAGGGCGTTCAAGTC-1	T cells
TCAGGGCTCGGACAAG-1	T cells
TCAGGGCTCTTTGCTA-1	T cells
TCAGGTAAGCGGTAGT-1	NK cells
TCAGGTACAATAGTGA-1	NK cells
TCAGTCCAGGCGACAT-1	T cells
TCAGTCCAGTCGAATA-1	T cells
TCAGTCCCACCATAAC-1	DC
TCAGTCCTCACTTATC-1	B cells
TCAGTCCTCGGCATTA-1	Macrophages
TCAGTCCTCGGCCAAC-1	Macrophages
TCAGTCCTCGTCCATC-1	T cells
TCAGTGAAGGTGCCAA-1	T cells
TCAGTGAAGTCATGAA-1	Epithelial cells
TCAGTGACAATTAGGA-1	T cells
TCAGTGACACCTCTAC-1	T cells
TCAGTGACACGCCAGT-1	T cells
TCAGTGACAGCACAGA-1	Plasma cells
TCAGTGAGTAACCCGC-1	T cells
TCAGTGAGTGAATGAT-1	T cells
TCAGTGATCAAGATAG-1	B cells
TCAGTGATCCGCCTAT-1	T cells
TCAGTGATCTCCGCAT-1	Fibroblasts
TCAGTTTCAGAAATTG-1	NK cells
TCAGTTTCATTACTCT-1	T cells
TCAGTTTTCGTTCAGA-1	T cells
TCATACTAGTGTAGTA-1	T cells
TCATACTCAAACGTGG-1	T cells
TCATACTCACTAGTAC-1	T cells
TCATACTCATTATGCG-1	T cells
TCATACTTCTTGGTCC-1	T cells
TCATATCAGACCAGCA-1	Macrophages
TCATATCCAACGCCCA-1	Macrophages
TCATATCCACCATAAC-1	Epithelial cells
TCATATCCACTGTGTA-1	T cells
TCATATCGTCATGGCC-1	Epithelial cells
TCATATCGTTGGGTTT-1	DC
TCATCATAGCGGGTTA-1	Monocytes
TCATCATCACGTACTA-1	T cells
TCATCATCAGTCGCAC-1	Epithelial cells
TCATCATCAGTTAGGG-1	T cells
TCATCATGTTTCGTGA-1	T cells
TCATCATTCATCGGGC-1	T cells
TCATCATTCCACATAG-1	T cells
TCATCATTCGCAGATT-1	T cells
TCATCCGAGTGGAATT-1	Epithelial cells
TCATCCGCAGGTCTCG-1	NK cells
TCATCCGGTCCATCTC-1	B cells
TCATCCGGTTTACACG-1	T cells
TCATCCGTCAAACGAA-1	T cells
TCATCCGTCCTTCTGG-1	T cells
TCATCCGTCGCACGGT-1	Epithelial cells
TCATGAGCATCGTCCT-1	T cells
TCATGAGGTAAGTTGA-1	Macrophages
TCATGAGGTCACTACA-1	Fibroblasts
TCATGAGGTTCTTAGG-1	B cells
TCATGAGTCTTCTCAA-1	T cells
TCATGCCAGGAGGCAG-1	Epithelial cells
TCATGCCCAGCTACTA-1	Epithelial cells
TCATGCCTCAGGCGAA-1	Epithelial cells
TCATGCCTCCAAGCTA-1	T cells
TCATGGAAGGTCGACA-1	Monocytes
TCATGTTCAGCGTGCT-1	Epithelial cells
TCATGTTGTCCACACG-1	T cells
TCATGTTTCTTAGGAC-1	Endothelial cells
TCATTACCAAGAGTAT-1	T cells
TCATTACCAATGAGCG-1	Plasma cells
TCATTACGTAGAAACT-1	Fibroblasts
TCATTACGTTGTCATG-1	T cells
TCATTACTCAAACGAA-1	T cells
TCATTACTCATCGGGC-1	T cells
TCATTACTCTAGGCAT-1	Monocytes
TCATTCAAGTGCTCAT-1	T cells
TCATTCATCGCCTTGT-1	T cells
TCATTCATCGGCACTG-1	T cells
TCATTCATCTGAGGCC-1	T cells
TCATTGTAGCGTCGAA-1	T cells
TCATTGTAGCTTCATG-1	T cells
TCATTGTGTGAATGAT-1	T cells
TCATTGTGTGTACGCC-1	T cells
TCATTGTGTGTTAACC-1	DC
TCATTGTGTTTACCAG-1	T cells
TCATTGTTCGCGAAGA-1	T cells
TCATTGTTCTGAGTCA-1	T cells
TCATTTGAGACCGTTT-1	T cells
TCATTTGCATCTTTCA-1	NK cells
TCATTTGTCAACTGAC-1	T cells
TCATTTGTCCTGGGAC-1	T cells
TCCACCAAGGCAATGC-1	Fibroblasts
TCCACCAAGGTAATCA-1	T cells
TCCACCAAGTCATGGG-1	T cells
TCCACCACAGTCAGCC-1	Endothelial cells
TCCACCACAGTTAGAA-1	Epithelial cells
TCCACCACATTGACCA-1	Monocytes
TCCACCAGTCTTCAAG-1	T cells
TCCACCATCTCGCAGG-1	T cells
TCCACGTAGAAAGTCT-1	B cells
TCCACGTAGGATCACG-1	Epithelial cells
TCCACGTAGGGCCTCT-1	NK cells
TCCACGTTCAAGTGTC-1	T cells
TCCACGTTCCGGCAGT-1	T cells
TCCAGAAAGCGATGAC-1	T cells
TCCAGAAAGCTGTACT-1	T cells
TCCAGAAAGGGCGAAG-1	T cells
TCCAGAAAGTACTGTC-1	T cells
TCCAGAACAACTGGTT-1	T cells
TCCAGAAGTGACGCCT-1	Macrophages
TCCAGAAGTGGTTTGT-1	B cells
TCCAGAAGTTCGATTG-1	T cells
TCCAGAATCCTAGCCT-1	T cells
TCCATCGAGCATCAGG-1	Macrophages
TCCATCGAGCGACTAG-1	T cells
TCCATCGAGCGTCAGA-1	DC
TCCATCGAGTCATTGC-1	T cells
TCCATCGCACTTGTCC-1	T cells
TCCATGCAGAACGTGC-1	T cells
TCCATGCAGCATACTC-1	T cells
TCCATGCCAGGACAGT-1	NK cells
TCCATGCGTACGTAGG-1	Epithelial cells
TCCATGCGTCATCAGT-1	T cells
TCCCACAAGGATACGC-1	T cells
TCCCACACAGCTTTGA-1	Epithelial cells
TCCCACACATCACAGT-1	T cells
TCCCACAGTACAACGG-1	Epithelial cells
TCCCACAGTTGGGTAG-1	Epithelial cells
TCCCACATCTGCATAG-1	Epithelial cells
TCCCAGTAGGAAGTGA-1	T cells
TCCCAGTAGGCCACCT-1	T cells
TCCCAGTCACTGCGTG-1	NK cells
TCCCAGTCAGTAGGAC-1	B cells
TCCCAGTGTAGGCTGA-1	T cells
TCCCAGTTCCATGAGT-1	T cells
TCCCAGTTCCTATTGT-1	T cells
TCCCATGAGGTAGACC-1	T cells
TCCCATGCAAGACAAT-1	T cells
TCCCATGCAGACACAG-1	T cells
TCCCATGCATGCGGTC-1	Epithelial cells
TCCCATGGTCATAACC-1	T cells
TCCCATGTCGGAATGG-1	Fibroblasts
TCCGAAACAATAGGGC-1	NK cells
TCCGAAAGTCAGTCCG-1	T cells
TCCGAAATCAGACCCG-1	T cells
TCCGAAATCGGTTGTA-1	T cells
TCCGAAATCTCCGCAT-1	Epithelial cells
TCCGATCAGAGCATTA-1	T cells
TCCGATCAGTCGAGGT-1	T cells
TCCGATCCAGTCGGAA-1	T cells
TCCGATCGTCATGACT-1	Epithelial cells
TCCGATCGTTGCTCCT-1	Epithelial cells
TCCGGGAAGCGGCTCT-1	T cells
TCCGGGACAACCCTAA-1	T cells
TCCGGGACAGTATTCG-1	Macrophages
TCCGGGAGTGGCTGAA-1	B cells
TCCGGGATCAGCTGAT-1	Epithelial cells
TCCGGGATCATAAGGA-1	Macrophages
TCCGGGATCTCATTGT-1	B cells
TCCGTGTCACGTAGTT-1	T cells
TCCGTGTGTTACCTGA-1	Epithelial cells
TCCGTGTTCACGGTCG-1	Epithelial cells
TCCGTGTTCTTAGCCC-1	T cells
TCCTAATAGAAACCCG-1	B cells
TCCTAATAGCGTCTGC-1	T cells
TCCTAATAGCTACTGT-1	T cells
TCCTAATAGGCTCAAG-1	T cells
TCCTAATGTGTTAGCT-1	T cells
TCCTAATGTTGCATTG-1	Fibroblasts
TCCTAATTCCACAAGT-1	T cells
TCCTAATTCCGACATA-1	T cells
TCCTCCCAGACTAAGT-1	T cells
TCCTCCCAGGGTTTCT-1	T cells
TCCTCCCCAAAGGCGT-1	T cells
TCCTCCCTCAGCGCAC-1	DC
TCCTCGACATGGCTGC-1	Epithelial cells
TCCTCGAGTGAACCGA-1	T cells
TCCTCGATCCTTATAC-1	Epithelial cells
TCCTCGATCGATCCAA-1	Epithelial cells
TCCTCGATCGGCTATA-1	T cells
TCCTCTTCACACCGAC-1	Monocytes
TCCTCTTGTCGTGGTC-1	T cells
TCCTGCAAGCCGTTGC-1	DC
TCCTGCAAGTAAACGT-1	Epithelial cells
TCCTGCAAGTGGTGGT-1	T cells
TCCTGCACAGCGGTCT-1	NK cells
TCCTGCAGTCAGGCAA-1	T cells
TCCTGCATCACCATAG-1	Epithelial cells
TCCTTCTCAGACAAAT-1	Epithelial cells
TCCTTCTCATCTGTTT-1	Macrophages
TCCTTCTGTACAGAAT-1	B cells
TCCTTCTGTACTGGGA-1	T cells
TCCTTCTTCCTGTACC-1	T cells
TCCTTCTTCGAGTACT-1	T cells
TCCTTTCAGAATGTTG-1	T cells
TCCTTTCAGAGTCAGC-1	T cells
TCCTTTCCAAGCTACT-1	Monocytes
TCCTTTCGTACAGTCT-1	T cells
TCCTTTCGTCAGACTT-1	Fibroblasts
TCCTTTCTCGTTCGCT-1	T cells
TCGAACAAGCATGCAG-1	Epithelial cells
TCGAACAAGCTAGTTC-1	Epithelial cells
TCGAACATCAGGGATG-1	T cells
TCGAACATCCGTAGGC-1	T cells
TCGAACATCGCCGAAC-1	T cells
TCGAAGTAGATTTGCC-1	T cells
TCGAAGTAGGTTGCCC-1	Macrophages
TCGAAGTCATCGTCCT-1	NK cells
TCGAAGTCATGATAGA-1	T cells
TCGAAGTGTCCCTCAT-1	Epithelial cells
TCGAAGTGTGCATACT-1	Fibroblasts
TCGAAGTTCCTCACCA-1	T cells
TCGAAGTTCGGTGTTA-1	Macrophages
TCGACCTAGGATTCAA-1	NK cells
TCGACCTAGGTCCCTG-1	Macrophages
TCGACCTGTGTCCTAA-1	Monocytes
TCGACCTGTTGGCCGT-1	NK cells
TCGACCTTCAAGTCTG-1	T cells
TCGACCTTCCTTGGAA-1	T cells
TCGACCTTCGGTTCAA-1	T cells
TCGACCTTCTAGCCAA-1	Macrophages
TCGACGGAGTTACGTC-1	B cells
TCGACGGCATCGGATT-1	Epithelial cells
TCGACGGGTCTGTGCG-1	Epithelial cells
TCGACGGGTTGCCATA-1	T cells
TCGACGGTCTTTCGAT-1	B cells
TCGATTTAGCAGATAT-1	T cells
TCGATTTAGCGAGGAG-1	Macrophages
TCGATTTCACAGTACT-1	T cells
TCGATTTTCCAGCCTT-1	Epithelial cells
TCGATTTTCTCCCTAG-1	NK cells
TCGCACTAGGTTTACC-1	Epithelial cells
TCGCACTTCAGCTTGA-1	Macrophages
TCGCACTTCGCAATGT-1	T cells
TCGCACTTCGTCCTTG-1	T cells
TCGCAGGAGACCACGA-1	Macrophages
TCGCAGGCAAATACGA-1	T cells
TCGCAGGCACATAGCT-1	T cells
TCGCAGGCACCCTCTA-1	DC
TCGCAGGCAGCCGTTG-1	NK cells
TCGCAGGCATGTGGCC-1	T cells
TCGCAGGCATTGTACG-1	DC
TCGCAGGGTATGAGGC-1	T cells
TCGCAGGGTGCCCACA-1	B cells
TCGCAGGTCGGACTTA-1	Epithelial cells
TCGCTCAAGCTAAGTA-1	Macrophages
TCGCTCACAATCTGCA-1	DC
TCGCTCACAGGATGAC-1	T cells
TCGCTCAGTCTTGCTC-1	Epithelial cells
TCGCTCAGTGACAGGT-1	Macrophages
TCGCTTGAGACTTCCA-1	Plasma cells
TCGCTTGGTAAGGCCA-1	Epithelial cells
TCGCTTGTCCTTATCA-1	T cells
TCGCTTGTCGCTGCGA-1	B cells
TCGCTTGTCGGCCAAC-1	Plasma cells
TCGGATAAGCACTCCG-1	T cells
TCGGATAGTATGGGAC-1	Macrophages
TCGGATAGTCCTACGG-1	Epithelial cells
TCGGATATCCACGTCT-1	NK cells
TCGGATATCGGCCCAA-1	Endothelial cells
TCGGGACCAAATGGCG-1	T cells
TCGGGACCACCTATCC-1	Macrophages
TCGGGACCACGGGCTT-1	T cells
TCGGGACGTATCGCGC-1	T cells
TCGGGACGTGTGTCCG-1	T cells
TCGGGCAAGAAACTCA-1	T cells
TCGGGCAAGTCTCGTA-1	Epithelial cells
TCGGGCACACTCAAGT-1	T cells
TCGGGCACATGGGATG-1	Epithelial cells
TCGGGCATCGGCTTCT-1	Epithelial cells
TCGGGTGTCAGCAGAG-1	Plasma cells
TCGGTCTAGATAGTCA-1	Fibroblasts
TCGGTCTCACAATGCT-1	Epithelial cells
TCGGTCTCACTCATAG-1	Fibroblasts
TCGGTCTCATGGCTAT-1	Epithelial cells
TCGGTCTGTGTTGAGG-1	T cells
TCGTAGACACTTGGGC-1	T cells
TCGTAGAGTACTCCGG-1	Epithelial cells
TCGTCCACAATCTAGC-1	Endothelial cells
TCGTCCACATCCAACA-1	T cells
TCGTGCTCATACGCAT-1	Macrophages
TCGTGCTCATCGAAGG-1	Monocytes
TCGTGCTTCAAGTGTC-1	T cells
TCGTGCTTCATCACAG-1	DC
TCGTGCTTCCACACAA-1	T cells
TCGTGCTTCGGACCAC-1	Macrophages
TCGTGGGAGCTAAGTA-1	T cells
TCGTGGGAGTGAGGTC-1	Plasma cells
TCGTGGGCACTGAGTT-1	DC
TCGTGGGTCCGTTGGG-1	T cells
TCGTGGGTCTCGTGAA-1	Epithelial cells
TCTAACTCAACCGCTG-1	T cells
TCTAACTTCAGTGTGT-1	T cells
TCTAACTTCATTATCC-1	Epithelial cells
TCTAACTTCTTCTGGC-1	NK cells
TCTACATAGAGTTGTA-1	Epithelial cells
TCTACATAGTAAGAGG-1	Epithelial cells
TCTACATCAAGTTGGG-1	T cells
TCTACATCATACCAGT-1	T cells
TCTACATGTAGCGCTC-1	T cells
TCTACATGTCTACTGA-1	T cells
TCTACATGTCTGTGTA-1	Monocytes
TCTACATGTGTATTCG-1	T cells
TCTACATGTTGTGGCC-1	B cells
TCTACCGAGACTCCGC-1	Epithelial cells
TCTACCGCACATAACC-1	T cells
TCTACCGCATGATCTG-1	T cells
TCTACCGTCTACGCGG-1	T cells
TCTACCGTCTGCGATA-1	DC
TCTATACAGCAAGCCA-1	pDC
TCTATACAGGTAGCCA-1	Epithelial cells
TCTATACCAATACGAA-1	Epithelial cells
TCTATACGTTATGTCG-1	T cells
TCTATACGTTTGCAGT-1	B cells
TCTATCAGTACCCGCA-1	Monocytes
TCTATCATCACCCTGT-1	T cells
TCTATCATCGTTGTTT-1	Epithelial cells
TCTCACGAGGTTATAG-1	T cells
TCTCACGAGTAGAGTT-1	Epithelial cells
TCTCACGGTCCTGGGT-1	NK cells
TCTCACGGTGTACGCC-1	T cells
TCTCACGGTTACCCTC-1	T cells
TCTCAGCAGGCTTTCA-1	Fibroblasts
TCTCAGCAGTGGACGT-1	T cells
TCTCAGCAGTGTACAA-1	DC
TCTCAGCGTTGACGGA-1	Macrophages
TCTCAGCGTTGACTAC-1	Macrophages
TCTCAGCTCCGCAACG-1	Epithelial cells
TCTCCGAAGCAAGTCG-1	Epithelial cells
TCTCCGAAGCCACCGT-1	T cells
TCTCCGACAGTAGGAC-1	T cells
TCTCCGACATGTTCAG-1	T cells
TCTCCGAGTCTACGAT-1	T cells
TCTCCGATCTGCGTCT-1	T cells
TCTCTGGAGATGTTGA-1	T cells
TCTCTGGAGTTGAAAC-1	Epithelial cells
TCTCTGGTCACTCTTA-1	T cells
TCTCTGGTCAGACCGC-1	B cells
TCTGCCAAGTTTCTTC-1	Epithelial cells
TCTGCCACAAAGGCGT-1	T cells
TCTGCCAGTAGTCTTG-1	T cells
TCTGGCTAGGCGATAC-1	T cells
TCTGGCTAGTTTGAGA-1	T cells
TCTGGCTCAGACATCT-1	T cells
TCTGGCTCATACCACA-1	T cells
TCTGGCTGTCGATTTG-1	Epithelial cells
TCTGGCTGTTACCCTC-1	DC
TCTGGCTTCAAGTTGC-1	T cells
TCTGGCTTCACCATAG-1	Epithelial cells
TCTGGCTTCAGGTGTT-1	T cells
TCTGTCGAGTTGTACC-1	T cells
TCTGTCGCAACAGAGC-1	T cells
TCTGTCGCAAGGCAAC-1	NK cells
TCTGTCGGTACACGTT-1	T cells
TCTGTCGGTATCAGCT-1	T cells
TCTGTCGTCCGTAGGC-1	NK cells
TCTTAGTAGCATATGA-1	NK cells
TCTTAGTAGGAATGTT-1	T cells
TCTTAGTAGTTCACTG-1	B cells
TCTTAGTCACATAGCT-1	Epithelial cells
TCTTAGTGTAGCTGAG-1	Epithelial cells
TCTTAGTGTCACCGCA-1	T cells
TCTTAGTGTCTAGTGT-1	T cells
TCTTAGTGTGAGGAAA-1	B cells
TCTTAGTGTGTTAACC-1	T cells
TCTTCCTAGAGTCAGC-1	T cells
TCTTCCTAGGACAAGA-1	T cells
TCTTCCTAGTATGACA-1	T cells
TCTTCCTCATGACTAC-1	T cells
TCTTCCTGTATGCGGA-1	Monocytes
TCTTCCTGTGTTAGCT-1	T cells
TCTTGCGAGAACCCGA-1	T cells
TCTTGCGAGACTCAAA-1	T cells
TCTTGCGGTGGGTATG-1	Macrophages
TCTTGCGTCAAATGCC-1	T cells
TCTTTGAAGACATATG-1	Epithelial cells
TCTTTGAAGCATTTCG-1	T cells
TCTTTGAAGTCCTGCG-1	Epithelial cells
TCTTTGACACATTACG-1	T cells
TCTTTGAGTCTTGAGT-1	Monocytes
TCTTTGAGTTCTGAGT-1	T cells
TCTTTGAGTTCTTCAT-1	T cells
TCTTTGATCCGTATGA-1	pDC
TCTTTGATCTACTCAT-1	Macrophages
TCTTTGATCTACTTCA-1	T cells
TGAACGTAGAGTCAAT-1	T cells
TGAACGTAGCGCTTCG-1	NK cells
TGAACGTTCACGGACC-1	Epithelial cells
TGAACGTTCTCCGCAT-1	T cells
TGAATCGCATATTCGG-1	T cells
TGAATCGGTGAATTAG-1	T cells
TGAATCGGTGATACCT-1	T cells
TGAATCGTCGCATTGA-1	Epithelial cells
TGAATCGTCTCAGAAC-1	Fibroblasts
TGAATGCAGTAAGACT-1	T cells
TGAATGCAGTATAGGT-1	T cells
TGAATGCTCCATTGGA-1	Macrophages
TGACAGTCAGGTGAGT-1	Epithelial cells
TGACAGTGTTTCCCAC-1	T cells
TGACCCTAGTCCCAAT-1	T cells
TGACCCTAGTTCCAGT-1	Epithelial cells
TGACCCTCAAATCAGA-1	T cells
TGACCCTCAGACCGCT-1	T cells
TGACCCTCAGTGTGGA-1	B cells
TGACCCTCATCATTGG-1	B cells
TGACCCTGTAGGAGTC-1	T cells
TGACCCTGTCGAATGG-1	Epithelial cells
TGACCCTTCACGTAGT-1	Monocytes
TGACGCGAGCAACTCT-1	Plasma cells
TGACGCGCAATTTCTC-1	T cells
TGACGCGGTTAATGAG-1	Epithelial cells
TGACTCCGTCTACGAT-1	Epithelial cells
TGACTCCTCCAAATGC-1	B cells
TGACTCCTCCTTCACG-1	T cells
TGAGACTAGGTGATAT-1	T cells
TGAGACTAGTCCCAAT-1	Monocytes
TGAGACTCAAAGCTCT-1	T cells
TGAGACTGTTGTATGC-1	T cells
TGAGACTTCAACCGAT-1	T cells
TGAGACTTCCTGTAAG-1	T cells
TGAGCATAGTCACGCC-1	Epithelial cells
TGAGCATCAGAGAAAG-1	Macrophages
TGAGCATCAGTCCCGA-1	Epithelial cells
TGAGCATTCATCGCAA-1	T cells
TGAGCATTCCAGCAAT-1	Epithelial cells
TGAGCATTCGTAGTGT-1	T cells
TGAGCGCAGTTTAGGA-1	DC
TGAGCGCCATACAGAA-1	Fibroblasts
TGAGCGCGTGTTCGTA-1	T cells
TGAGGAGAGCCGGAAT-1	Monocytes
TGAGGAGAGGCTCCCA-1	T cells
TGAGGAGCAATGCTCA-1	Epithelial cells
TGAGGAGCATCATCTT-1	NK cells
TGAGGAGGTACTCCCT-1	T cells
TGAGGAGGTGCCCGTA-1	T cells
TGAGGAGTCAAGATAG-1	Macrophages
TGAGGGAAGAGAGCCT-1	Monocytes
TGAGGGACACTACCGG-1	T cells
TGAGGGACAGCACAGA-1	B cells
TGAGGGAGTTTGGGTT-1	T cells
TGAGGTTCAGTCCGTG-1	T cells
TGAGGTTGTGTGTTTG-1	Macrophages
TGAGGTTTCCTCACGT-1	Epithelial cells
TGAGTCAAGGGCGAAG-1	T cells
TGAGTCAAGTCCCTAA-1	DC
TGAGTCACAACGCATT-1	NK cells
TGAGTCATCATGCAGT-1	Monocytes
TGAGTCATCCTAACAG-1	T cells
TGATCAGCACACCAGC-1	Monocytes
TGATCAGTCGTTATCT-1	T cells
TGATCTTAGTGTTCCA-1	Epithelial cells
TGATCTTCAGTTTCGA-1	DC
TGATCTTGTCAAAGCG-1	T cells
TGATCTTGTGGCTACC-1	T cells
TGATCTTGTTTGGCTA-1	Macrophages
TGATGCACAACAGTGG-1	T cells
TGATGCAGTGCCCACA-1	T cells
TGATGCATCATAGACC-1	T cells
TGATGCATCCACACCT-1	T cells
TGATGGTAGGCGTTGA-1	T cells
TGATGGTAGGTCCGAA-1	Fibroblasts
TGATGGTCATGTTTGG-1	Macrophages
TGATGGTGTCAGACGA-1	Epithelial cells
TGATGGTTCCAGTTCC-1	T cells
TGATGGTTCTGGACCG-1	T cells
TGATTCTAGGCCACCT-1	Epithelial cells
TGATTCTAGGGCATGT-1	Epithelial cells
TGATTCTCATCGAAGG-1	T cells
TGATTCTGTATCGATC-1	B cells
TGATTCTGTCATGCAT-1	Epithelial cells
TGATTCTGTTACCTTT-1	T cells
TGATTCTGTTCGTTCC-1	T cells
TGATTCTGTTCTCTCG-1	T cells
TGATTCTTCGACCTAA-1	Macrophages
TGATTTCCACAACGAG-1	T cells
TGATTTCCACAGAGCA-1	Fibroblasts
TGATTTCCACTTGGGC-1	T cells
TGATTTCGTCGAGATG-1	T cells
TGATTTCGTTCGAAGG-1	T cells
TGATTTCTCGGTGAAG-1	Epithelial cells
TGCACGGAGACATCAA-1	Monocytes
TGCACGGAGATGGTAT-1	Macrophages
TGCACGGAGCTAGCCC-1	T cells
TGCACGGGTGTATTCG-1	DC
TGCACGGTCTGAGATC-1	DC
TGCAGATAGAGACAAG-1	T cells
TGCAGATAGAGCTGCA-1	T cells
TGCAGATAGCATGGGT-1	DC
TGCAGATAGTAATTGG-1	Fibroblasts
TGCAGATCAAAGGCAC-1	T cells
TGCAGATCAACTGGTT-1	T cells
TGCAGATCACGCCAGT-1	T cells
TGCAGATGTACGATGG-1	T cells
TGCAGATGTCAAACGG-1	T cells
TGCAGATGTGGCAACA-1	Macrophages
TGCAGATGTGGTCTGC-1	B cells
TGCAGATTCATAGGCT-1	T cells
TGCAGATTCATGTCAG-1	T cells
TGCAGGCAGGCAGCTA-1	T cells
TGCAGGCAGGCTTAGG-1	Macrophages
TGCAGGCAGGTTTACC-1	T cells
TGCAGGCGTATCGTAC-1	T cells
TGCAGGCGTGCGCTCA-1	T cells
TGCAGGCTCCACGTGG-1	NK cells
TGCAGGCTCGTTCAGA-1	T cells
TGCAGGCTCTTCGACC-1	Epithelial cells
TGCAGTACAAGTTCCA-1	B cells
TGCAGTACAATAGGAT-1	T cells
TGCAGTAGTTACCGTA-1	Epithelial cells
TGCAGTATCAAGATAG-1	T cells
TGCAGTATCATGAGTC-1	Fibroblasts
TGCATCCAGACATCCT-1	T cells
TGCATCCAGCGTTCCG-1	T cells
TGCATCCAGGCGAACT-1	B cells
TGCATCCAGTTCCGGC-1	Epithelial cells
TGCATCCCAACTGATC-1	T cells
TGCATCCGTACTGGGA-1	Epithelial cells
TGCATCCTCGATCCCT-1	T cells
TGCATGAAGCATGCGA-1	Epithelial cells
TGCATGAAGGAAACGA-1	Epithelial cells
TGCATGAAGTCAATCC-1	T cells
TGCATGACATGTCTAG-1	T cells
TGCATGATCCCAGGAC-1	Macrophages
TGCATGATCGCCAGTG-1	T cells
TGCATGATCTAGTACG-1	Macrophages
TGCCGAGAGAGTTGTA-1	T cells
TGCCGAGCATGTTCAG-1	T cells
TGCCGAGGTCCACATA-1	Epithelial cells
TGCGACGCATAATGCC-1	Endothelial cells
TGCGACGGTCAACGCC-1	T cells
TGCGACGGTGTTATCG-1	Endothelial cells
TGCGACGTCAGAATAG-1	NK cells
TGCGATAAGGGTCTTT-1	B cells
TGCGATAAGTTGAATG-1	Epithelial cells
TGCGATACACGAAGAC-1	Monocytes
TGCGATAGTCATACCA-1	DC
TGCGATAGTCTACGTA-1	T cells
TGCGATAGTCTTCTAT-1	T cells
TGCGATATCAACTTTC-1	T cells
TGCGGCAAGGCCTAAG-1	T cells
TGCGGCACACAATGCT-1	T cells
TGCGGCACAGTTCTAG-1	T cells
TGCGGCAGTTCCGCAG-1	T cells
TGCGGCATCCGAGATT-1	T cells
TGCGGCATCCGGTAAT-1	Epithelial cells
TGCGGGTAGAAGGTAG-1	T cells
TGCGGGTAGCGCACAA-1	Monocytes
TGCGGGTAGTACAGAT-1	T cells
TGCGGGTCAACGGCTC-1	T cells
TGCGGGTCACTACGGC-1	T cells
TGCGGGTCAGCGTTTA-1	DC
TGCGGGTCATCACGGC-1	Monocytes
TGCGGGTGTATCGTTG-1	Monocytes
TGCGGGTGTCTTGGTA-1	T cells
TGCTCCAAGACAACTA-1	T cells
TGCTCCAAGCTTGTTG-1	Epithelial cells
TGCTCCAGTTCATCGA-1	T cells
TGCTCCAGTTGTGCAT-1	T cells
TGCTCCATCGAATCCA-1	Epithelial cells
TGCTCCATCTCTATGT-1	T cells
TGCTCGTCACCAGCGT-1	DC
TGCTCGTCAGCGAGTA-1	Plasma cells
TGCTCGTCAGCGATTT-1	T cells
TGCTCGTCATGACGGA-1	Fibroblasts
TGCTCGTGTCTGATCA-1	Monocytes
TGCTCGTTCGCTAGCG-1	T cells
TGCTCGTTCTACTATC-1	T cells
TGCTGAAAGCATTTGC-1	DC
TGCTGAAAGTGGATAT-1	T cells
TGCTGAACAACGGTAG-1	T cells
TGCTGAACACATACTG-1	T cells
TGCTGAACAGTCAGTT-1	T cells
TGCTGAAGTAAGAACT-1	DC
TGCTGAATCGACGCTG-1	T cells
TGCTTCGAGCCTTTCC-1	T cells
TGCTTCGAGCGTATAA-1	NK cells
TGCTTCGAGGCATGGT-1	DC
TGCTTCGAGGCTGTAG-1	pDC
TGCTTCGCAAGCGGAT-1	T cells
TGCTTCGCACAGTATC-1	Macrophages
TGCTTCGCATCATCCC-1	T cells
TGCTTCGGTTAGCTAC-1	Fibroblasts
TGCTTCGTCAGGAACG-1	B cells
TGCTTGCGTAATGCGG-1	Epithelial cells
TGCTTGCGTAGGGTAC-1	Macrophages
TGCTTGCGTCATAGTC-1	T cells
TGCTTGCGTCGAACGA-1	DC
TGCTTGCGTCTGATAC-1	Macrophages
TGCTTGCTCCGACGGT-1	B cells
TGGAACTAGCGTGCTC-1	T cells
TGGAACTCAAATAAGC-1	Epithelial cells
TGGAACTCATTCACAG-1	T cells
TGGAGAGAGCTACGTT-1	Macrophages
TGGAGAGGTATGGAGC-1	T cells
TGGAGAGTCGGAGTGA-1	T cells
TGGAGAGTCTACCCAC-1	T cells
TGGAGGAAGTAAACTG-1	Macrophages
TGGAGGAAGTGGACGT-1	Epithelial cells
TGGAGGAGTCAGGCAA-1	Macrophages
TGGAGGAGTCGTACTA-1	Epithelial cells
TGGAGGAGTGGTTCTA-1	Epithelial cells
TGGAGGATCTAAGCCA-1	T cells
TGGATCACAGCTACCG-1	T cells
TGGATCACAGTTGCGC-1	Macrophages
TGGATCACATACCACA-1	Epithelial cells
TGGATCACATGCCGAC-1	Fibroblasts
TGGATCAGTAATGCGG-1	Fibroblasts
TGGATCATCCTGGTCT-1	T cells
TGGATCATCTGTGCAA-1	T cells
TGGATGTAGACATACA-1	Epithelial cells
TGGATGTAGGACATCG-1	NK cells
TGGATGTCAGGTCCGT-1	T cells
TGGATGTCAGGTGACA-1	T cells
TGGCGTGCATATAGCC-1	T cells
TGGCGTGGTAGGGAGG-1	T cells
TGGCGTGTCAGAGCGA-1	T cells
TGGGAAGCAGCTGAAG-1	Macrophages
TGGGAAGCATGTGTCA-1	T cells
TGGGAAGGTTCTAAGC-1	T cells
TGGGAAGTCCGCAGTG-1	T cells
TGGGAAGTCCGCATAA-1	Fibroblasts
TGGGAAGTCGTAGTCA-1	T cells
TGGGAGACAACACAGG-1	T cells
TGGGAGATCAACCTTT-1	T cells
TGGGAGATCGCCTATC-1	Macrophages
TGGGATTAGGAAAGGT-1	T cells
TGGGATTCACAATGAA-1	T cells
TGGGATTCAGTTACCA-1	T cells
TGGGATTGTGACGTCC-1	T cells
TGGGATTGTGTCCTAA-1	T cells
TGGGATTTCAAGAAAC-1	Macrophages
TGGGATTTCCCAGGAC-1	Fibroblasts
TGGGATTTCCGTGTAA-1	Epithelial cells
TGGGATTTCGCCAATA-1	T cells
TGGGATTTCGGATACT-1	Epithelial cells
TGGGATTTCGTAACAC-1	T cells
TGGGCGTAGCTCCACG-1	T cells
TGGGCGTAGGTATCTC-1	Epithelial cells
TGGGCGTGTCTAACGT-1	Epithelial cells
TGGGCGTTCCCGGTAG-1	T cells
TGGGCTGAGTGTCATC-1	DC
TGGGCTGCAGCTATTG-1	T cells
TGGGCTGCAGGCAATG-1	T cells
TGGGCTGGTAGGTTTC-1	NK cells
TGGGCTGGTGTCCTAA-1	Fibroblasts
TGGGCTGGTTGGGCCT-1	DC
TGGGCTGTCAATGTCG-1	T cells
TGGGTTAAGCCAAGCA-1	Monocytes
TGGGTTAAGGTGCTTT-1	Epithelial cells
TGGGTTAAGGTTACAA-1	pDC
TGGGTTAGTTGCTGAT-1	Macrophages
TGGGTTATCTTGATTC-1	Macrophages
TGGTACACACAATTCG-1	T cells
TGGTACACACCAGCCA-1	Macrophages
TGGTACACACCTGCAG-1	NK cells
TGGTACACATTCAGGT-1	NK cells
TGGTACAGTGTCTTCC-1	DC
TGGTAGTGTATGAGAT-1	T cells
TGGTAGTTCAATCTTC-1	T cells
TGGTAGTTCCTGTACC-1	Epithelial cells
TGGTAGTTCTACACTT-1	T cells
TGGTGATGTCTAGGCC-1	B cells
TGGTGATGTTAGGACG-1	DC
TGGTGATTCAAACGTC-1	DC
TGGTGATTCGGCTTGG-1	T cells
TGGTGATTCTCTTCAA-1	NK cells
TGGTTAGCAAAGCTAA-1	T cells
TGGTTAGCATAATGCC-1	T cells
TGGTTAGGTCAGTCTA-1	B cells
TGTAACGAGGAAGTAG-1	T cells
TGTAACGAGGACCCAA-1	Macrophages
TGTAACGAGGGCAACT-1	pDC
TGTAACGTCTTAGGAC-1	T cells
TGTAAGCAGCTCCCTT-1	T cells
TGTAAGCCAGAGTGTG-1	T cells
TGTAAGCGTACTAAGA-1	T cells
TGTAAGCGTAGCGTAG-1	T cells
TGTAAGCGTGAGTAAT-1	Macrophages
TGTAAGCGTTTACGAC-1	T cells
TGTAAGCTCGACGATT-1	T cells
TGTAAGCTCTTGAGCA-1	T cells
TGTACAGAGAACGTGC-1	Epithelial cells
TGTACAGCACCGGAAA-1	T cells
TGTACAGGTACTGAGG-1	Epithelial cells
TGTACAGGTACTGCGC-1	Monocytes
TGTACAGGTCTCAGAT-1	Macrophages
TGTACAGTCATTCACT-1	T cells
TGTACAGTCCAGCTCT-1	T cells
TGTAGACAGGTGCCTC-1	T cells
TGTAGACCACATGAAA-1	Epithelial cells
TGTAGACCATCCCACT-1	Macrophages
TGTAGACGTGGTACAG-1	T cells
TGTAGACGTGTGGACA-1	Epithelial cells
TGTAGACGTTCCACGG-1	DC
TGTCAGAGTCTGTGGC-1	T cells
TGTCAGATCCCAAGTA-1	Epithelial cells
TGTCAGATCGATACGT-1	pDC
TGTCAGATCTCAACGA-1	T cells
TGTCCACAGTAACCGG-1	T cells
TGTCCACAGTGATAGT-1	Plasma cells
TGTCCACCATGCGGTC-1	T cells
TGTCCACGTTCCGGTG-1	T cells
TGTCCACTCAAGTGTC-1	T cells
TGTCCCACAAGAGTTA-1	NK cells
TGTCCCACAAGTGCTT-1	T cells
TGTCCCACAGATACTC-1	DC
TGTCCCATCGAGCTGC-1	Epithelial cells
TGTCCTGAGCAGCCCT-1	Macrophages
TGTCCTGAGTCGCCCA-1	NK cells
TGTCCTGGTGCTCTCT-1	DC
TGTCCTGGTGGAGAAA-1	T cells
TGTCCTGGTGTACAGG-1	T cells
TGTCCTGTCACATTGG-1	DC
TGTGAGTAGACGGTCA-1	NK cells
TGTGAGTAGTGAGTTA-1	pDC
TGTGAGTGTCCCTGTT-1	NK cells
TGTGAGTTCGTTAGTG-1	Epithelial cells
TGTGATGAGCAACAAT-1	Monocytes
TGTGATGAGCGTGAAC-1	DC
TGTGATGAGGTGCTGA-1	T cells
TGTGATGGTCACATTG-1	T cells
TGTGATGTCTTTCAGT-1	T cells
TGTGCGGCACTGCGTG-1	NK cells
TGTGCGGCAGGGTTGA-1	NK cells
TGTGCGGCATGACTAC-1	Fibroblasts
TGTGCGGCATTACGGT-1	T cells
TGTGCGGGTTAGCGGA-1	T cells
TGTGCGGTCGCCTTGT-1	T cells
TGTGCGGTCTCGGGAC-1	Epithelial cells
TGTGGCGAGATGTTGA-1	Monocytes
TGTGGCGAGTGGATTA-1	Epithelial cells
TGTGGCGGTCGCGTTG-1	B cells
TGTGTGAAGATGGGCT-1	T cells
TGTGTGAAGCGGTAAC-1	T cells
TGTGTGACACACCGAC-1	T cells
TGTGTGAGTATGACAA-1	T cells
TGTGTGATCCAATCTT-1	T cells
TGTTACTAGCTCACTA-1	Epithelial cells
TGTTACTCAAGGGCAT-1	T cells
TGTTACTCACTACTTT-1	NK cells
TGTTACTGTCTGTCCT-1	Monocytes
TGTTACTTCTGTGTGA-1	Epithelial cells
TGTTCATCAAGAGGCT-1	T cells
TGTTCATCAGAGTTCT-1	T cells
TGTTCATCAGCAGACA-1	T cells
TGTTCATTCTGCATGA-1	T cells
TGTTCCGAGTCCTGTA-1	T cells
TGTTCCGCAAACAGGC-1	T cells
TGTTCCGGTACGTGTT-1	T cells
TGTTCCGGTTGTGTAC-1	T cells
TGTTCCGTCCTCGATC-1	T cells
TGTTCTAAGGCACTAG-1	T cells
TGTTCTACAGCGGATA-1	Macrophages
TGTTCTAGTGTCCATA-1	T cells
TGTTCTATCGCGTGCA-1	T cells
TGTTCTATCTACTCAT-1	Epithelial cells
TGTTGAGAGCGACTAG-1	DC
TGTTGAGAGGATCACG-1	Macrophages
TGTTGAGAGGTGGTTG-1	Macrophages
TGTTGAGCACCGTCGA-1	T cells
TGTTGAGGTAGGACTG-1	Epithelial cells
TGTTGAGGTCGAGTTT-1	Epithelial cells
TGTTGAGGTTGCCTAA-1	T cells
TGTTGGACACCAGTTA-1	T cells
TGTTGGACACCATTCC-1	T cells
TGTTGGACACCTCAGG-1	NK cells
TGTTGGACATTGCAAC-1	Epithelial cells
TGTTGGAGTAGCTGCC-1	Epithelial cells
TGTTGGAGTCGTAATC-1	T cells
TGTTTGTAGGCGATAC-1	B cells
TGTTTGTCACGCCAGT-1	T cells
TGTTTGTCATGGGTCC-1	T cells
TGTTTGTGTGACGCCT-1	Macrophages
TGTTTGTGTGGATCGA-1	Monocytes
TGTTTGTGTTGTGCCG-1	DC
TGTTTGTTCAAATGAG-1	T cells
TGTTTGTTCAAGTAAG-1	T cells
TTAATCCAGCTCGTGC-1	Macrophages
TTAATCCCAAGCGAGT-1	Epithelial cells
TTAATCCCACCGTCGA-1	T cells
TTAATCCCAGAGGTTG-1	Epithelial cells
TTAATCCGTAACGGTG-1	T cells
TTAATCCGTCAGATTC-1	T cells
TTAATCCTCACCCTCA-1	Macrophages
TTAATCCTCACGGGCT-1	T cells
TTACAGGAGCATCCCG-1	B cells
TTACAGGCAACATCGT-1	T cells
TTACAGGGTGCTATTG-1	Fibroblasts
TTACAGGGTTCTCACC-1	T cells
TTACAGGTCCGATTAG-1	DC
TTACCATAGTCGCTAT-1	Macrophages
TTACCATAGTTGTAGA-1	Epithelial cells
TTACCATTCCTCTCGA-1	T cells
TTACCATTCTTACGGA-1	T cells
TTACCGCAGACAGTCG-1	Epithelial cells
TTACCGCAGGCTTAGG-1	T cells
TTACCGCAGTATCTGC-1	Epithelial cells
TTACCGCCAAGACGGT-1	Fibroblasts
TTACCGCCAAGTAGTA-1	Fibroblasts
TTACCGCGTTCCCAAA-1	Epithelial cells
TTACCGCTCGGAGTGA-1	T cells
TTACCGCTCGTAACTG-1	Macrophages
TTACCGCTCTAGTGTG-1	T cells
TTACCGCTCTCAACCC-1	T cells
TTACCGCTCTCTGCCA-1	Macrophages
TTACGCCAGATGAAGG-1	Epithelial cells
TTACGCCGTATCCTCC-1	Macrophages
TTACGTTAGCACAAAT-1	T cells
TTACGTTGTCCTGGTG-1	Macrophages
TTACGTTTCATTGAGC-1	pDC
TTACTGTAGATTGAGT-1	T cells
TTACTGTAGTAGCATA-1	Epithelial cells
TTACTGTAGTGGTTGG-1	T cells
TTACTGTTCAGAGCAG-1	T cells
TTACTGTTCATAGAGA-1	NK cells
TTACTGTTCATCGCCT-1	NK cells
TTACTGTTCGCGGTAC-1	Macrophages
TTAGGCAAGAAACTGT-1	Epithelial cells
TTAGGCAAGATTAGAC-1	T cells
TTAGGCACACGTTCGG-1	T cells
TTAGGCACATCATTTC-1	T cells
TTAGGCAGTAATACCC-1	T cells
TTAGGCATCGACGACC-1	T cells
TTAGGGTAGATTACCC-1	Monocytes
TTAGGGTAGTTCATGC-1	T cells
TTAGGGTCAGCTAACT-1	Macrophages
TTAGGGTGTGTCACAT-1	Epithelial cells
TTAGGGTGTTATAGAG-1	DC
TTAGGGTTCCAAGCAT-1	Monocytes
TTAGGGTTCTCGCTCA-1	Plasma cells
TTAGTCTAGTTCCGGC-1	Fibroblasts
TTAGTCTGTCCCGGTA-1	Epithelial cells
TTAGTCTTCATTCGGA-1	Monocytes
TTAGTCTTCGAGAAGC-1	T cells
TTAGTCTTCGCCAATA-1	Fibroblasts
TTAGTCTTCTTTCAGT-1	Macrophages
TTATTGCAGGTGGGTT-1	T cells
TTATTGCCAGATGCGA-1	B cells
TTATTGCGTATACAGA-1	T cells
TTATTGCGTTACCCAA-1	Macrophages
TTATTGCGTTGCCGAC-1	T cells
TTATTGCTCGGTGTAT-1	Macrophages
TTCAATCAGATGTTAG-1	T cells
TTCAATCAGCGCCTTG-1	T cells
TTCAATCCACGCTATA-1	Macrophages
TTCAATCGTACAGGTG-1	T cells
TTCAATCGTAGTCCTA-1	T cells
TTCAATCGTATCCCAA-1	T cells
TTCAATCGTATGGTTC-1	pDC
TTCAATCGTGTGTTTG-1	NK cells
TTCAATCTCATCTGTT-1	T cells
TTCAATCTCATTGAGC-1	Epithelial cells
TTCAATCTCGATTTCT-1	T cells
TTCAATCTCTAGAGCT-1	Epithelial cells
TTCAATCTCTAGTCAG-1	Endothelial cells
TTCACCGAGCGACCCT-1	Endothelial cells
TTCACCGAGGGATCGT-1	T cells
TTCACCGCAGGTCCGT-1	T cells
TTCACCGTCCCGAGGT-1	Macrophages
TTCACCGTCGTGCAGC-1	Endothelial cells
TTCACCGTCGTGGCGT-1	T cells
TTCACCGTCTTCGGAA-1	Endothelial cells
TTCACGCAGAAGCGCT-1	T cells
TTCACGCAGGCTAACG-1	T cells
TTCACGCAGTAGAGTT-1	Macrophages
TTCACGCCATAGCACT-1	Macrophages
TTCACGCGTAACATCC-1	T cells
TTCACGCGTAATGCGG-1	T cells
TTCACGCGTATCAGGG-1	Macrophages
TTCACGCTCGACTCCT-1	T cells
TTCACGCTCGCAGATT-1	Epithelial cells
TTCACGCTCTAGTGAC-1	T cells
TTCAGGAAGCCTTTCC-1	T cells
TTCAGGAAGGACGGAG-1	Epithelial cells
TTCAGGACATACAGCT-1	T cells
TTCAGGAGTCAACCTA-1	Epithelial cells
TTCAGGAGTCCAGCCA-1	T cells
TTCAGGAGTTCAGTAC-1	Monocytes
TTCAGGATCCGTGGCA-1	T cells
TTCATGTCAACTGCCG-1	Macrophages
TTCATGTCAAGACTGG-1	Macrophages
TTCATGTCAATTGTGC-1	T cells
TTCATGTCAGCGACAA-1	T cells
TTCATGTGTCGACTTA-1	T cells
TTCATGTGTTGCCATA-1	T cells
TTCATTGAGACCTCAT-1	T cells
TTCATTGAGATGCTTC-1	NK cells
TTCATTGAGCAGCCCT-1	T cells
TTCATTGAGGGCAGGA-1	Epithelial cells
TTCATTGAGTTCAACC-1	Macrophages
TTCATTGCAACCCGCA-1	T cells
TTCATTGGTGTGTACT-1	T cells
TTCATTGTCTTCCTAA-1	T cells
TTCCAATAGCATCAGG-1	T cells
TTCCAATAGGAGTATT-1	T cells
TTCCAATCACTGATTG-1	T cells
TTCCAATGTTCTCCCA-1	T cells
TTCCAATTCGGTTCAA-1	T cells
TTCCAATTCTGAACGT-1	Epithelial cells
TTCCACGAGTGATAAC-1	Epithelial cells
TTCCACGCACGTAGAG-1	DC
TTCCACGCAGAGATTA-1	Epithelial cells
TTCCACGCAGATCACT-1	T cells
TTCCACGGTTTGGGTT-1	T cells
TTCCGGTAGGCGCTTC-1	Epithelial cells
TTCCGGTGTACGAGTG-1	T cells
TTCCGGTGTATGTCAC-1	Epithelial cells
TTCCGGTTCATTCGTT-1	Epithelial cells
TTCCGTGAGTCGCCCA-1	T cells
TTCCGTGAGTTGCCCG-1	T cells
TTCCGTGAGTTGCTCA-1	T cells
TTCCGTGCACCGTGCA-1	Plasma cells
TTCCGTGCACCTATCC-1	Epithelial cells
TTCCGTGCAGTTGGTT-1	Plasma cells
TTCCGTGGTACCCGCA-1	B cells
TTCCGTGGTCACGACC-1	Monocytes
TTCCGTGTCTCGCTTG-1	T cells
TTCCTAAAGGGTCTTT-1	T cells
TTCCTAACAGCTCTGG-1	DC
TTCCTAAGTATCTCTT-1	T cells
TTCCTAATCAAACGTC-1	DC
TTCCTAATCGATGGAG-1	Epithelial cells
TTCCTAATCTAGCATG-1	T cells
TTCCTAATCTTCACAT-1	Epithelial cells
TTCCTCTCAAGCCCAC-1	T cells
TTCCTCTGTAACGTTC-1	T cells
TTCCTCTGTGGATGAC-1	pDC
TTCCTCTGTGGCATCC-1	T cells
TTCCTCTGTTGCATGT-1	pDC
TTCCTTCAGTTCCAGT-1	T cells
TTCCTTCCAAAGTGTA-1	Macrophages
TTCCTTCCAACACAAA-1	T cells
TTCCTTCCACTACCCT-1	Epithelial cells
TTCCTTCCACTAGGCC-1	T cells
TTCCTTCGTGGACTAG-1	Epithelial cells
TTCCTTCGTTACGATC-1	Epithelial cells
TTCCTTCGTTTGAACC-1	B cells
TTCCTTCTCGCATGAT-1	Monocytes
TTCGATTAGACACACG-1	Epithelial cells
TTCGATTAGCCTGAAG-1	DC
TTCGATTAGGCCCGTT-1	B cells
TTCGATTCAACCGCTG-1	T cells
TTCGATTCATAATGAG-1	T cells
TTCGATTGTCCCGCAA-1	T cells
TTCGATTGTCTACGAT-1	T cells
TTCGATTGTGGCCTCA-1	Monocytes
TTCGATTTCATCTGTT-1	T cells
TTCGATTTCGGAAACG-1	Fibroblasts
TTCGATTTCTCCTGTG-1	T cells
TTCGATTTCTGCCCTA-1	NK cells
TTCGCTGAGGTGGTTG-1	Epithelial cells
TTCGCTGAGTAACGTA-1	Macrophages
TTCGCTGAGTTGCCTA-1	T cells
TTCGCTGCAAAGCGTG-1	T cells
TTCGCTGCAGCAGAAC-1	T cells
TTCGCTGCAGGCTATT-1	T cells
TTCGCTGTCGTAATGC-1	T cells
TTCGGTCAGGTTTACC-1	Endothelial cells
TTCGGTCAGTGGATAT-1	B cells
TTCGGTCGTGATACAA-1	T cells
TTCTAACCAAACTCGT-1	T cells
TTCTAACGTAAGCTCT-1	T cells
TTCTAACTCAGGAACG-1	T cells
TTCTAGTAGAATAGTC-1	T cells
TTCTAGTCACGTACAT-1	T cells
TTCTCTCCAACAAGAT-1	T cells
TTCTCTCGTGGTCTTA-1	DC
TTCTCTCGTTGGGACA-1	Macrophages
TTCTCTCTCCAGCTCT-1	Macrophages
TTCTCTCTCCCTTGGT-1	Macrophages
TTCTCTCTCGAACTCA-1	T cells
TTCTCTCTCTAGTTCT-1	Epithelial cells
TTCTGTACAACTGGTT-1	Macrophages
TTCTGTAGTATCTCTT-1	T cells
TTCTGTAGTGCTCTTC-1	Macrophages
TTCTGTATCACCTGGG-1	Macrophages
TTCTTCCAGAGTGGCT-1	T cells
TTCTTCCAGTTCATGC-1	T cells
TTCTTCCCACTCACTC-1	T cells
TTCTTCCGTCCAACGC-1	Macrophages
TTCTTCCTCAAAGCCT-1	Macrophages
TTCTTCCTCCCTCTAG-1	T cells
TTCTTCCTCTCTAAGG-1	T cells
TTCTTGAAGATGAACT-1	Macrophages
TTCTTGACAAGATGTA-1	Epithelial cells
TTCTTGACAGAGAAAG-1	Macrophages
TTCTTGACAGATCATC-1	Epithelial cells
TTCTTGACATCCGAAT-1	T cells
TTGAACGAGCTCGGCT-1	Fibroblasts
TTGAACGAGGTACAGC-1	B cells
TTGAACGAGGTGCATG-1	NK cells
TTGAACGCAAGTGTCT-1	T cells
TTGAACGCACACCGAC-1	B cells
TTGAACGCAGTGTGCC-1	T cells
TTGAACGGTATGACAA-1	T cells
TTGAACGGTGCCTTCT-1	T cells
TTGACCCAGGGTTGCA-1	T cells
TTGACCCCATCTAACG-1	T cells
TTGACCCTCCATCTCG-1	T cells
TTGACCCTCGCAGTGC-1	Epithelial cells
TTGACCCTCGTTACCC-1	Epithelial cells
TTGACCCTCTAAGCCA-1	T cells
TTGAGTGCAAACACCT-1	T cells
TTGAGTGCACATGACT-1	T cells
TTGAGTGCACCCTATC-1	T cells
TTGAGTGCATCCGATA-1	Epithelial cells
TTGAGTGGTATTTCTC-1	T cells
TTGAGTGTCTGTGCGG-1	Epithelial cells
TTGATGGAGATCCGAG-1	Macrophages
TTGATGGAGGGAGGTG-1	Epithelial cells
TTGATGGCACGGAAGT-1	T cells
TTGATGGGTATCGTAC-1	Epithelial cells
TTGATGGTCGTCTCAC-1	T cells
TTGCATTAGTCTGGTT-1	NK cells
TTGCATTGTACGAGTG-1	Fibroblasts
TTGCATTGTCACCCTT-1	T cells
TTGCCTGCAGCTCGGT-1	Macrophages
TTGCCTGCAGTCGCAC-1	DC
TTGCGTCTCCCGTTCA-1	T cells
TTGCGTCTCGCAACAT-1	T cells
TTGCTGCAGATTCGAA-1	B cells
TTGCTGCAGGACTATA-1	Epithelial cells
TTGCTGCAGGGCAGTT-1	Epithelial cells
TTGCTGCGTGAGTTTC-1	T cells
TTGCTGCTCAATCCGA-1	Epithelial cells
TTGCTGCTCGACATAC-1	Macrophages
TTGCTGCTCTGACGCG-1	Epithelial cells
TTGGATGAGAGTATAC-1	T cells
TTGGATGAGTCTAACC-1	T cells
TTGGATGCATCGTTCC-1	Epithelial cells
TTGGATGGTAGTCCTA-1	T cells
TTGGGATCACACCGCA-1	DC
TTGGGATTCATGCCCT-1	T cells
TTGGGATTCCTTTGAT-1	T cells
TTGGGCGCACAAGCAG-1	T cells
TTGGGCGCAGAGTTGG-1	Epithelial cells
TTGGGCGGTGAAGCGT-1	T cells
TTGGGTAAGGACAAGA-1	Epithelial cells
TTGGGTACACTTCTCG-1	NK cells
TTGGGTACAGGCACTC-1	NK cells
TTGGGTACATGATCTG-1	T cells
TTGGGTAGTAGTCTGT-1	T cells
TTGGTTTAGGACAGTC-1	Macrophages
TTGGTTTCACCGGTCA-1	Monocytes
TTGGTTTGTACAACGG-1	Endothelial cells
TTGGTTTGTTAGGAGC-1	T cells
TTGGTTTTCATGAAAG-1	DC
TTGGTTTTCCATCTAT-1	Endothelial cells
TTGGTTTTCCGTGTAA-1	Monocytes
TTGTGGAAGACAGCTG-1	Macrophages
TTGTGGAAGGAGTCTG-1	T cells
TTGTGGAAGGCTCTCG-1	T cells
TTGTGGAAGGCTGGAT-1	T cells
TTGTGGACATCTTAGG-1	Epithelial cells
TTGTGTTAGTACGAGC-1	T cells
TTGTGTTAGTATTGCC-1	Epithelial cells
TTGTGTTAGTTGTCGT-1	T cells
TTGTGTTTCCCTTGGT-1	Epithelial cells
TTGTGTTTCGCCACTT-1	T cells
TTGTGTTTCGGTCGAC-1	T cells
TTGTTCACAACGGGTA-1	T cells
TTGTTCAGTTGGGAAC-1	T cells
TTGTTCATCAACCTTT-1	T cells
TTGTTCATCGAATCCA-1	Macrophages
TTGTTCATCTCCCAAC-1	Macrophages
TTGTTCATCTCTGCCA-1	T cells
TTGTTGTGTGACTAAA-1	DC
TTGTTGTTCCATGCAA-1	T cells
TTGTTGTTCCCAAGTA-1	Epithelial cells
TTGTTGTTCGACGAGA-1	Epithelial cells
TTGTTGTTCGTAGTGT-1	Macrophages
TTGTTGTTCTGAGCAT-1	NK cells
TTGTTTGAGAGTCTGG-1	Monocytes
TTGTTTGAGATGCGAC-1	T cells
TTGTTTGAGGGATGTC-1	Epithelial cells
TTGTTTGCAATCTCTT-1	NK cells
TTGTTTGCACTGGACC-1	B cells
TTGTTTGCAGGTGGAT-1	T cells
TTGTTTGGTTCTCACC-1	Epithelial cells
TTGTTTGTCGATGCAT-1	T cells
TTGTTTGTCGCACGGT-1	Macrophages
TTTACCACAGTCAGAG-1	DC
TTTACCAGTTAAGACA-1	Epithelial cells
TTTACCAGTTCGTAAC-1	T cells
TTTACCATCATTGCGA-1	T cells
TTTACCATCGACATCA-1	Epithelial cells
TTTACCATCGTTCTCG-1	T cells
TTTACCATCTTGAGCA-1	B cells
TTTACGTAGACATACA-1	T cells
TTTACGTAGGAGCAAA-1	Macrophages
TTTACGTTCCACGAAT-1	T cells
TTTACTGAGAGCACTG-1	T cells
TTTACTGGTACTGACT-1	T cells
TTTACTGGTCCTGTCT-1	T cells
TTTACTGTCAACTACG-1	T cells
TTTACTGTCCCTCTAG-1	T cells
TTTACTGTCGCCGTGA-1	Macrophages
TTTAGTCAGTAGGATT-1	T cells
TTTAGTCCACAAATCC-1	T cells
TTTAGTCCAGGTCAAG-1	DC
TTTAGTCCATCCTATT-1	T cells
TTTAGTCTCGTTGCCT-1	Macrophages
TTTATGCCACAATGAA-1	NK cells
TTTATGCCACCGTCTT-1	T cells
TTTATGCGTGTTGATC-1	T cells
TTTATGCTCACGTCCT-1	T cells
TTTCACAAGCACGTCC-1	T cells
TTTCACAAGGCCCAAA-1	Macrophages
TTTCACAAGGTGGCTA-1	Fibroblasts
TTTCACAAGTATGGCG-1	Epithelial cells
TTTCACAGTTGACTGT-1	Epithelial cells
TTTCACATCGCTTACC-1	Monocytes
TTTCACATCTTCCCAG-1	Fibroblasts
TTTCAGTAGCAAATGT-1	T cells
TTTCAGTAGCCGGATA-1	T cells
TTTCAGTAGTCTAGCT-1	B cells
TTTCAGTCACATACGT-1	Fibroblasts
TTTCAGTCACATTGTG-1	T cells
TTTCAGTCAGAACATA-1	Monocytes
TTTCAGTTCAGCTTGA-1	T cells
TTTCATGCACGCGTGT-1	Epithelial cells
TTTCATGCACGGTGCT-1	T cells
TTTCATGGTCGCTGCA-1	T cells
TTTCATGGTTCTCTAT-1	T cells
TTTCATGTCATTTCGT-1	T cells
TTTCATGTCTTTGCGC-1	Epithelial cells
TTTCCTCAGCATGGGT-1	B cells
TTTCCTCGTCCGAAGA-1	T cells
TTTCGATCATTCATCT-1	Epithelial cells
TTTCGATGTTTCTATC-1	T cells
TTTCGATTCAGTCCGG-1	T cells
TTTGACTAGGAGTATT-1	Macrophages
TTTGACTAGTTCCGGC-1	DC
TTTGACTGTCGTAATC-1	DC
TTTGACTGTCTGGTTA-1	Epithelial cells
TTTGACTGTGTGCCTG-1	T cells
TTTGACTTCGGTTAGT-1	Macrophages
TTTGACTTCTCTTCAA-1	T cells
TTTGATCAGAGAAGGT-1	T cells
TTTGATCAGCTTCTAG-1	T cells
TTTGATCGTCGAACGA-1	T cells
TTTGGAGCACTGTTCC-1	NK cells
TTTGGAGCAGTCCGTG-1	NK cells
TTTGGAGGTCAAGCGA-1	T cells
TTTGGAGGTTCGGGTC-1	T cells
TTTGGAGTCAAGGAGC-1	NK cells
TTTGGTTAGACATCCT-1	T cells
TTTGGTTAGGCTCACC-1	T cells
TTTGGTTCACATTCTT-1	Epithelial cells
TTTGGTTGTCAGCGTC-1	T cells
TTTGGTTTCCTCAGAA-1	DC
TTTGGTTTCGACCTAA-1	T cells
TTTGGTTTCTTAGCAG-1	T cells
TTTGGTTTCTTTGCGC-1	T cells
TTTGTTGCAAATGCTC-1	T cells
TTTGTTGCAAGACCGA-1	T cells
TTTGTTGCACTTCAGA-1	Monocytes
TTTGTTGCATCTGCGG-1	Epithelial cells
TTTGTTGGTGTAGGAC-1	Epithelial cells
TTTGTTGGTGTGAGCA-1	T cells
