Barcode	cellType
AAACCCAAGCAATTAG-1	Fibroblasts
AAACCCAAGGTGCTAG-1	T cells
AAACCCAGTAATGCGG-1	Fibroblasts
AAACCCAGTCCACACG-1	T cells
AAACCCATCAACTGGT-1	Monocytes
AAACCCATCATCACTT-1	T cells
AAACCCATCATGAGTC-1	Endothelial cells
AAACCCATCGAGTGGA-1	Monocytes
AAACCCATCGGACTTA-1	Monocytes
AAACGAAAGAGAGCCT-1	Epithelial cells
AAACGAAAGTGATCGG-1	Fibroblasts
AAACGAACAGAGTCAG-1	Epithelial cells
AAACGAAGTAGAGTTA-1	Endothelial cells
AAACGAAGTTCGGCCA-1	NK cells
AAACGAATCAGTCCGG-1	T cells
AAACGAATCCCTATTA-1	Fibroblasts
AAACGCTAGAGGGTGG-1	Monocytes
AAACGCTAGAGTCCGA-1	Epithelial cells
AAACGCTAGGGCTGAT-1	Fibroblasts
AAACGCTAGTAGCATA-1	Endothelial cells
AAACGCTCAGAGACTG-1	Epithelial cells
AAACGCTGTGCTTCAA-1	Fibroblasts
AAACGCTGTTCACCGG-1	Fibroblasts
AAACGCTTCATTTCCA-1	Fibroblasts
AAAGAACAGTCGCTAT-1	NK cells
AAAGAACAGTTAGAAC-1	Endothelial cells
AAAGAACCATTACGGT-1	Fibroblasts
AAAGAACGTACGGCAA-1	Fibroblasts
AAAGAACGTGTTAACC-1	Epithelial cells
AAAGAACTCAGACCCG-1	T cells
AAAGGATAGTTCATGC-1	Macrophages
AAAGGATCAAAGGCAC-1	Fibroblasts
AAAGGATCACGACGAA-1	B cells
AAAGGATGTAACCCTA-1	Fibroblasts
AAAGGATGTAACGGTG-1	T cells
AAAGGATGTAGAGACC-1	B cells
AAAGGATGTCCAAATC-1	B cells
AAAGGGCAGTTCTCTT-1	Endothelial cells
AAAGGGCCAGTTGCGC-1	Epithelial cells
AAAGGGCCATGGGTCC-1	T cells
AAAGGGCGTGATAGTA-1	Monocytes
AAAGGGCGTGTGGACA-1	T cells
AAAGGGCGTGTTCGAT-1	Fibroblasts
AAAGGGCTCAGTGCGC-1	T cells
AAAGGTAAGCTTAGTC-1	Epithelial cells
AAAGGTACATGTCAGT-1	Fibroblasts
AAAGGTATCTGGAAGG-1	Fibroblasts
AAAGTCCCAACAGCTT-1	Fibroblasts
AAAGTCCGTGCCGTAC-1	T cells
AAAGTCCTCGATACGT-1	Epithelial cells
AAAGTGAAGCCGTTAT-1	Mast cells
AAAGTGACAGCTTTCC-1	T cells
AAAGTGAGTAGGACCA-1	T cells
AAAGTGATCGACGCGT-1	Fibroblasts
AAAGTGATCTAGCCAA-1	B cells
AAAGTGATCTGGGATT-1	T cells
AAATGGACATCCTCAC-1	T cells
AAATGGACATCCTTGC-1	Epithelial cells
AAATGGAGTAGACGGT-1	T cells
AAATGGAGTTCTTGCC-1	B cells
AAATGGATCTGAGAAA-1	ILC
AACAAAGCAGGAGGTT-1	Monocytes
AACAAAGGTAGAATAC-1	Endothelial cells
AACAAAGTCAGCGCAC-1	Fibroblasts
AACAAAGTCTACAGGT-1	T cells
AACAAAGTCTCTGCCA-1	Monocytes
AACAACCAGAGCGACT-1	Endothelial cells
AACAACCAGGTTCCAT-1	Epithelial cells
AACAACCCACTTCAGA-1	Monocytes
AACAACCCAGCAGTGA-1	B cells
AACAACCCATCGAACT-1	Epithelial cells
AACAACCGTAGTTAGA-1	Macrophages
AACAACCGTTCTCGTC-1	Fibroblasts
AACAACCTCCTAAACG-1	T cells
AACAACCTCGCAATTG-1	pDC
AACAACCTCTAAGAAG-1	pDC
AACAACCTCTCATGCC-1	T cells
AACAACCTCTGTCCGT-1	Endothelial cells
AACAAGAAGAAGAGCA-1	T cells
AACAAGAAGACGGTCA-1	Fibroblasts
AACAAGAAGCTCCCTT-1	Endothelial cells
AACAAGAAGTCATTGC-1	Fibroblasts
AACAAGACAGACAAAT-1	DC
AACAAGACAGTTTCGA-1	Fibroblasts
AACAAGAGTACCACGC-1	Monocytes
AACAAGAGTGGTCAAG-1	Monocytes
AACAAGAGTTCTCAGA-1	T cells
AACAAGATCAACTGGT-1	Epithelial cells
AACAAGATCGGCCTTT-1	T cells
AACAAGATCTACACTT-1	T cells
AACACACAGCGCGTTC-1	T cells
AACACACAGGGTACGT-1	NK cells
AACACACCAATGGGTG-1	Macrophages
AACACACGTAATTAGG-1	NK cells
AACACACGTACTAGCT-1	Epithelial cells
AACACACGTCCCTGTT-1	Monocytes
AACACACTCAAAGACA-1	T cells
AACACACTCCCTCATG-1	DC
AACAGGGAGACGGATC-1	T cells
AACAGGGAGACTAGAT-1	T cells
AACAGGGAGGTGATAT-1	Epithelial cells
AACAGGGCACTCGATA-1	Epithelial cells
AACAGGGCAGTTGGTT-1	Fibroblasts
AACAGGGGTTCATCTT-1	Epithelial cells
AACAGGGTCACTCCGT-1	Fibroblasts
AACAGGGTCCCTCTTT-1	Endothelial cells
AACAGGGTCCTCTAAT-1	Epithelial cells
AACCAACAGAGTCAAT-1	Macrophages
AACCAACAGCACCCAC-1	Fibroblasts
AACCAACAGGTCACCC-1	Epithelial cells
AACCAACAGTGGCAGT-1	T cells
AACCAACTCAGTGTCA-1	Macrophages
AACCAACTCGATTTCT-1	Fibroblasts
AACCAACTCGCCGATG-1	Fibroblasts
AACCACAAGGGCAAGG-1	Epithelial cells
AACCACAAGGTCACAG-1	Macrophages
AACCACAAGGTTCATC-1	T cells
AACCACACAAACACGG-1	Fibroblasts
AACCACACAAATGGAT-1	T cells
AACCACACAAGGCGTA-1	Epithelial cells
AACCACACAGCTATAC-1	B cells
AACCACAGTCATCGGC-1	Epithelial cells
AACCACAGTTTGACAC-1	Epithelial cells
AACCACATCCTCACGT-1	DC
AACCACATCGCGTAGC-1	Fibroblasts
AACCATGAGGCATGCA-1	DC
AACCATGCACTTGGCG-1	Fibroblasts
AACCATGCATCGTCCT-1	Endothelial cells
AACCATGTCGCCATAA-1	T cells
AACCATGTCTGGCCAG-1	Epithelial cells
AACCCAAAGACAGCGT-1	pDC
AACCCAACACCCAACG-1	Fibroblasts
AACCCAACAGCTGGTC-1	Fibroblasts
AACCCAACATCTGTTT-1	Macrophages
AACCCAAGTATCTCTT-1	Epithelial cells
AACCCAAGTCTACACA-1	T cells
AACCCAAGTTTCGCTC-1	Fibroblasts
AACCCAATCGCATTAG-1	Fibroblasts
AACCTGAAGCACGGAT-1	Fibroblasts
AACCTGACAACTAGAA-1	T cells
AACCTGACACAGAAGC-1	T cells
AACCTGACAGATCCTA-1	T cells
AACCTGAGTCCTTTGC-1	Epithelial cells
AACCTGAGTGTGTGGA-1	NK cells
AACCTGAGTTCTTAGG-1	Fibroblasts
AACCTTTAGGGAGGCA-1	Fibroblasts
AACCTTTCAAACTGCT-1	Fibroblasts
AACCTTTCACTAACGT-1	T cells
AACCTTTCAGTGCCTG-1	Endothelial cells
AACCTTTGTATCGTAC-1	Epithelial cells
AACCTTTTCCTCTAAT-1	Fibroblasts
AACGAAAAGCCGCTTG-1	Fibroblasts
AACGAAAAGTCCCGAC-1	Fibroblasts
AACGAAAAGTCGCCCA-1	Epithelial cells
AACGAAACACCCTCTA-1	Endothelial cells
AACGAAATCTTACCGC-1	T cells
AACGGGAAGCATATGA-1	Fibroblasts
AACGGGAAGTGAGCCA-1	Fibroblasts
AACGGGAGTCAGCTTA-1	T cells
AACGGGAGTGAAGCTG-1	T cells
AACGGGAGTTGTGGCC-1	T cells
AACGTCACACCGTCTT-1	Epithelial cells
AACGTCACAGTTAAAG-1	Fibroblasts
AACGTCACATGAGATA-1	Epithelial cells
AACTTCTAGGCATCGA-1	Monocytes
AACTTCTCAAATTAGG-1	Epithelial cells
AACTTCTTCAGCACCG-1	pDC
AACTTCTTCCCGTGAG-1	Fibroblasts
AAGAACACACAGAAGC-1	NK cells
AAGAACAGTACGTACT-1	Fibroblasts
AAGACAACAACCCTCT-1	Monocytes
AAGACAACACGACCTG-1	Fibroblasts
AAGACAACACTTGAAC-1	Fibroblasts
AAGACAACAGGTTCAT-1	Macrophages
AAGACAAGTTCTCCAC-1	Fibroblasts
AAGACTCAGCACTAGG-1	Monocytes
AAGACTCCAGGAATCG-1	Endothelial cells
AAGACTCGTCAGGCAA-1	T cells
AAGACTCGTGGTTTAC-1	T cells
AAGACTCGTGTGGACA-1	Monocytes
AAGACTCTCGCTCTCA-1	Fibroblasts
AAGATAGAGCTTACGT-1	Fibroblasts
AAGATAGAGGCCACCT-1	Fibroblasts
AAGATAGCAAGGAGTC-1	Fibroblasts
AAGATAGGTTGCTCAA-1	Epithelial cells
AAGATAGTCTATCGTT-1	T cells
AAGATAGTCTGGTTGA-1	T cells
AAGCATCAGCAGGCTA-1	DC
AAGCATCAGTCGCTAT-1	T cells
AAGCATCCATCTCCCA-1	Epithelial cells
AAGCATCCATTCCTCG-1	Fibroblasts
AAGCATCTCAGCGCAC-1	T cells
AAGCATCTCATGCCCT-1	Fibroblasts
AAGCATCTCATTTACC-1	Fibroblasts
AAGCATCTCCGACAGC-1	Epithelial cells
AAGCATCTCCGATGTA-1	T cells
AAGCATCTCGGCTATA-1	B cells
AAGCATCTCTTGGTCC-1	Monocytes
AAGCCATAGACCATGG-1	T cells
AAGCCATAGGAACATT-1	T cells
AAGCCATCAACTTGGT-1	ILC
AAGCCATCATTGGATC-1	Endothelial cells
AAGCGAGAGAGTTCGG-1	Epithelial cells
AAGCGAGAGCACCGTC-1	NK cells
AAGCGAGCATTGCCTC-1	Monocytes
AAGCGAGGTCTCAAGT-1	T cells
AAGCGAGGTGCAATGG-1	T cells
AAGCGAGGTTATCCAG-1	Endothelial cells
AAGCGAGTCGCTACAA-1	Epithelial cells
AAGCGAGTCTCAATCT-1	pDC
AAGCGAGTCTCAGAAC-1	T cells
AAGCGAGTCTTTGCTA-1	DC
AAGCGTTCAAGCGGAT-1	T cells
AAGCGTTCAGTCGGTC-1	T cells
AAGCGTTCAGTTGGTT-1	Epithelial cells
AAGCGTTCATGGGCAA-1	Fibroblasts
AAGCGTTGTCGTACAT-1	Monocytes
AAGCGTTGTGTCGATT-1	Epithelial cells
AAGCGTTTCAGACATC-1	T cells
AAGCGTTTCCATCAGA-1	ILC
AAGCGTTTCGAGCTGC-1	B cells
AAGCGTTTCGCCGATG-1	Endothelial cells
AAGCGTTTCGTTGCCT-1	DC
AAGGAATAGAATCGTA-1	Fibroblasts
AAGGAATAGCGATGGT-1	Epithelial cells
AAGGAATAGCGCCTTG-1	T cells
AAGGAATAGGATGGCT-1	Epithelial cells
AAGGAATAGGGCAGAG-1	Fibroblasts
AAGGAATAGTTTGAGA-1	Fibroblasts
AAGGAATCAACCGCTG-1	Fibroblasts
AAGGAATCAACTGTGT-1	T cells
AAGGAATCACGGCACT-1	Fibroblasts
AAGGAATGTTGCATTG-1	B cells
AAGGAATTCAAGCCAT-1	Fibroblasts
AAGGAATTCCTGGCTT-1	DC
AAGGAATTCTCATGCC-1	T cells
AAGGTAACACCCTAAA-1	Fibroblasts
AAGGTAACAGGAGGAG-1	Fibroblasts
AAGGTAAGTAATGATG-1	Macrophages
AAGGTAAGTCTGTAAC-1	T cells
AAGGTAATCTACAGGT-1	T cells
AAGTACCAGGACAGCT-1	T cells
AAGTACCGTAGAGGAA-1	T cells
AAGTACCGTCGCCACA-1	Macrophages
AAGTACCTCGCGTTTC-1	T cells
AAGTACCTCGGAAACG-1	Epithelial cells
AAGTCGTAGGTCCTGC-1	Epithelial cells
AAGTCGTGTCGTGGAA-1	T cells
AAGTCGTTCAGTGTGT-1	Epithelial cells
AAGTCGTTCCTGTTGC-1	DC
AAGTCGTTCTTTCCAA-1	T cells
AAGTGAAAGAGCTTTC-1	T cells
AAGTGAAGTCAGATTC-1	T cells
AAGTGAAGTCTATGAC-1	Epithelial cells
AAGTGAAGTGCCTGAC-1	Fibroblasts
AAGTGAAGTGTGTGTT-1	T cells
AAGTGAATCAGCTGTA-1	DC
AAGTGAATCATCACCC-1	Fibroblasts
AAGTGAATCGTTCCTG-1	T cells
AAGTGAATCTGTAAGC-1	Epithelial cells
AAGTTCGAGACTCCGC-1	Endothelial cells
AAGTTCGAGATGAACT-1	Monocytes
AAGTTCGAGTGCGTCC-1	T cells
AATAGAGCACAGCCAC-1	Fibroblasts
AATAGAGCAGCGACCT-1	Fibroblasts
AATAGAGGTATAGCTC-1	Fibroblasts
AATAGAGTCCCGGTAG-1	NK cells
AATAGAGTCCCTTTGG-1	Fibroblasts
AATCACGCACGACCTG-1	Epithelial cells
AATCACGCATACCGTA-1	T cells
AATCACGGTATGAGGC-1	Fibroblasts
AATCACGGTTCACCGG-1	T cells
AATCACGTCCACCTCA-1	Fibroblasts
AATCACGTCCTGGCTT-1	Fibroblasts
AATCACGTCGCAGTGC-1	Endothelial cells
AATCACGTCTTTGGAG-1	pDC
AATCGACAGAAACCCG-1	T cells
AATCGACAGCAACAAT-1	T cells
AATCGACAGCATCTTG-1	Epithelial cells
AATCGACAGCCTAGGA-1	T cells
AATCGACAGTTTCAGC-1	Fibroblasts
AATCGACCAGACCTGC-1	T cells
AATCGACGTAATTGGA-1	Fibroblasts
AATCGACGTGATAGAT-1	Epithelial cells
AATCGACTCATGTCTT-1	Fibroblasts
AATCGACTCTCCGTGT-1	Epithelial cells
AATCGACTCTTTCAGT-1	T cells
AATCGTGAGACCAGAC-1	Epithelial cells
AATCGTGAGCTTGTTG-1	T cells
AATCGTGCAAACGAGC-1	T cells
AATCGTGCAGCTAACT-1	Fibroblasts
AATCGTGGTTAGAGTA-1	Fibroblasts
AATCGTGGTTCTAACG-1	Fibroblasts
AATGAAGAGCGTGTCC-1	Epithelial cells
AATGAAGCACAAACGG-1	B cells
AATGAAGCACAAGCCC-1	T cells
AATGAAGCACATGGTT-1	Monocytes
AATGAAGCATCCTTGC-1	T cells
AATGAAGGTGTGTTTG-1	T cells
AATGAAGGTTGTCTAG-1	T cells
AATGAAGTCAACACCA-1	Monocytes
AATGAAGTCACCACAA-1	T cells
AATGAAGTCCCAAGTA-1	Monocytes
AATGAAGTCTTACCAT-1	T cells
AATGACCAGTAAGAGG-1	DC
AATGACCCACCGTCTT-1	Endothelial cells
AATGACCGTGAGTTGG-1	T cells
AATGACCTCTAGTACG-1	Fibroblasts
AATGACCTCTGTCGCT-1	T cells
AATGCCAAGAGCATTA-1	Epithelial cells
AATGCCAAGCACGGAT-1	Monocytes
AATGCCAAGCACTCAT-1	Epithelial cells
AATGCCACAAATCGGG-1	Epithelial cells
AATGCCAGTAGCGTTT-1	T cells
AATGCCAGTCCCACGA-1	Fibroblasts
AATGCCATCGATCCAA-1	T cells
AATGGAATCTCCGAAA-1	Monocytes
AATGGCTAGCAACAGC-1	T cells
AATGGCTAGCCTCAGC-1	Endothelial cells
AATGGCTCAAACTCTG-1	T cells
AATGGCTTCAGCAATC-1	Fibroblasts
AATGGCTTCTAGCCAA-1	B cells
AATGGCTTCTCATTAC-1	Epithelial cells
AATTCCTAGGTGCGAT-1	Endothelial cells
AATTCCTAGTTGTCAC-1	Fibroblasts
AATTCCTCATCCGTGG-1	B cells
AATTCCTGTATGTCTG-1	NK cells
AATTCCTTCCCTTCCC-1	T cells
AATTCCTTCTTACTGT-1	Macrophages
AATTTCCCAGCTACCG-1	Fibroblasts
AATTTCCTCCACTGGG-1	Epithelial cells
AATTTCCTCGCTGTCT-1	Fibroblasts
AATTTCCTCGTCACCT-1	Monocytes
AATTTCCTCTATACTC-1	Fibroblasts
AATTTCCTCTCCAATT-1	Epithelial cells
ACAAAGAAGATGGTCG-1	Fibroblasts
ACAAAGACATGACTAC-1	T cells
ACAAAGACATGAGGGT-1	DC
ACAAAGAGTACGCTTA-1	T cells
ACAAAGAGTCTACGTA-1	Fibroblasts
ACAAAGAGTGGTGATG-1	Monocytes
ACAAAGAGTGTTTGCA-1	T cells
ACAAAGAGTTAATGAG-1	T cells
ACAAAGATCCGTTTCG-1	T cells
ACAAAGATCGAGAAAT-1	Fibroblasts
ACAACCACAGAATTCC-1	pDC
ACAACCACAGTCGCTG-1	T cells
ACAACCACATACCACA-1	Monocytes
ACAAGCTAGGATTTCC-1	Fibroblasts
ACAAGCTAGGGTTTCT-1	T cells
ACAAGCTAGTCAGCGA-1	Epithelial cells
ACAAGCTCAATTGGTC-1	T cells
ACAAGCTCACTGGATT-1	Fibroblasts
ACAAGCTCAGAAATCA-1	Epithelial cells
ACAAGCTCATTGGCAT-1	B cells
ACAAGCTGTTTCCATT-1	Epithelial cells
ACAAGCTTCGCATTAG-1	Monocytes
ACAAGCTTCTACCTTA-1	Fibroblasts
ACACAGTCAGGCTTGC-1	Monocytes
ACACAGTCATTAGGCT-1	Monocytes
ACACAGTTCACCCTTG-1	Endothelial cells
ACACAGTTCTATACGG-1	Fibroblasts
ACACCAAAGCGACAGT-1	T cells
ACACCAACAACACGAG-1	Fibroblasts
ACACCAACAAGCGCAA-1	T cells
ACACCAACACCAGACC-1	T cells
ACACCAAGTAGTCGGA-1	T cells
ACACCAAGTCTCGGGT-1	NK cells
ACACCAATCGCCTCTA-1	T cells
ACACCAATCGGAAACG-1	Monocytes
ACACCAATCTTAGGAC-1	T cells
ACACGCGAGGAGAGGC-1	T cells
ACACGCGCAGTTACCA-1	Epithelial cells
ACACGCGCATCGTGGC-1	T cells
ACACGCGGTGTTCCTC-1	Monocytes
ACACGCGTCCTAGCCT-1	Fibroblasts
ACACGCGTCTGGACCG-1	T cells
ACACTGAAGACGAAGA-1	Fibroblasts
ACACTGAAGCAACAGC-1	ILC
ACACTGAAGGGTACGT-1	T cells
ACACTGAAGTTACGGG-1	Epithelial cells
ACACTGACAGCAGAAC-1	Fibroblasts
ACACTGACATTGGCAT-1	T cells
ACACTGAGTAGGTAGC-1	Epithelial cells
ACACTGAGTCGTCAGC-1	Epithelial cells
ACACTGATCAATCCAG-1	Epithelial cells
ACACTGATCCTTTAGT-1	Epithelial cells
ACAGAAAAGAGGTGCT-1	Monocytes
ACAGAAAAGTGTCATC-1	B cells
ACAGAAACAACTTGCA-1	Monocytes
ACAGAAATCTGTAACG-1	pDC
ACAGAAATCTGTGTGA-1	Epithelial cells
ACAGCCGAGAGCCGAT-1	Fibroblasts
ACAGCCGAGCTAATCC-1	T cells
ACAGCCGAGGTAGCAC-1	Epithelial cells
ACAGCCGAGTCTTCGA-1	T cells
ACAGCCGCACACCGCA-1	DC
ACAGCCGCACGACTAT-1	Epithelial cells
ACAGCCGGTCGCGTCA-1	Fibroblasts
ACAGCCGGTCGGCCTA-1	T cells
ACAGCCGGTGCACGCT-1	T cells
ACAGCCGGTGTATCCA-1	T cells
ACAGCCGGTGTCCACG-1	Epithelial cells
ACAGCCGGTTTGTGGT-1	Epithelial cells
ACAGGGAAGCCAGAGT-1	T cells
ACAGGGAAGGACGGAG-1	Endothelial cells
ACAGGGAGTAGCTGAG-1	B cells
ACAGGGATCAGGAAAT-1	T cells
ACATCCCAGCCTGTCG-1	Epithelial cells
ACATCCCAGTGAGGTC-1	Fibroblasts
ACATCCCCATGGAAGC-1	Monocytes
ACATCCCGTAGGCTGA-1	Monocytes
ACATCCCTCTCCTGAC-1	B cells
ACATCGAAGTGATGGC-1	B cells
ACATCGACAGAGATTA-1	Monocytes
ACATCGACAGGCTACC-1	Endothelial cells
ACATCGACATCGCTGG-1	Fibroblasts
ACATCGACATGATCTG-1	T cells
ACATCGAGTCCATCTC-1	Epithelial cells
ACATCGAGTCCTGGGT-1	Epithelial cells
ACATCGATCGCACTCT-1	pDC
ACATCGATCGGCATCG-1	T cells
ACATCGATCTAAGCCA-1	pDC
ACATGCAAGTCTGGAG-1	Fibroblasts
ACATGCACAAAGCACG-1	T cells
ACATGCACAGAAGTTA-1	B cells
ACATGCAGTACGCGTC-1	T cells
ACATGCATCATGCTAG-1	NK cells
ACATGCATCGCTTGCT-1	Fibroblasts
ACATGCATCGGCTATA-1	T cells
ACATTTCAGACCAAAT-1	DC
ACATTTCAGGTGATAT-1	Fibroblasts
ACATTTCCATTGGATC-1	T cells
ACATTTCGTATCACCA-1	Epithelial cells
ACATTTCGTCTACATG-1	Epithelial cells
ACATTTCGTGCTCTTC-1	Fibroblasts
ACATTTCTCTGGTCAA-1	T cells
ACCAAACAGGTACCTT-1	Mast cells
ACCAAACCAATAACCC-1	Fibroblasts
ACCAAACCACTGAATC-1	Monocytes
ACCAAACGTGGAGGTT-1	B cells
ACCAAACGTTTGAACC-1	T cells
ACCAAACTCCGCTAGG-1	Epithelial cells
ACCAACAAGTCATTGC-1	Monocytes
ACCAACAAGTCGAAGC-1	Fibroblasts
ACCAACACAAATCGTC-1	Fibroblasts
ACCAACACAAGCGGAT-1	T cells
ACCAACAGTACAACGG-1	Epithelial cells
ACCAACATCCTCAGGG-1	Fibroblasts
ACCAACATCGACGTCG-1	Fibroblasts
ACCAACATCGAGAATA-1	T cells
ACCAACATCGAGCCTG-1	DC
ACCACAAAGAGGCGGA-1	Macrophages
ACCACAAAGTTGGGAC-1	T cells
ACCACAATCAATCAGC-1	Fibroblasts
ACCATTTAGTGAGGTC-1	Fibroblasts
ACCATTTCAGAATCGG-1	Epithelial cells
ACCATTTCAGTTGCGC-1	Fibroblasts
ACCATTTGTAGCTGTT-1	T cells
ACCATTTGTCCTACAA-1	pDC
ACCATTTGTTCGTAAC-1	T cells
ACCCAAACACAACATC-1	Epithelial cells
ACCCAAACACGTGTGC-1	Epithelial cells
ACCCAAACACTGATTG-1	T cells
ACCCAAAGTAGCCAGA-1	Epithelial cells
ACCCAAAGTTCCCACT-1	T cells
ACCCAAATCGTTCAGA-1	Epithelial cells
ACCCTCAAGCAACAGC-1	T cells
ACCCTCAAGGCGAAGG-1	T cells
ACCCTCACAATGCAGG-1	Fibroblasts
ACCCTCACAGCAATTC-1	Fibroblasts
ACCCTCACATTACGGT-1	T cells
ACCCTCAGTACCTGTA-1	Epithelial cells
ACCCTCAGTCCCACGA-1	Fibroblasts
ACCCTCAGTCGAGTTT-1	T cells
ACCCTCAGTCGGCACT-1	Monocytes
ACCCTCATCCAAGCTA-1	Epithelial cells
ACCCTCATCCGTGGTG-1	T cells
ACCCTCATCGTGCGAC-1	Fibroblasts
ACCCTCATCTTCACGC-1	T cells
ACCCTTGAGGTTCCAT-1	T cells
ACCCTTGCAAGCAATA-1	T cells
ACCCTTGCAAGCTACT-1	B cells
ACCCTTGTCAACCGAT-1	Fibroblasts
ACCGTTCAGATCCTAC-1	T cells
ACCGTTCAGCATCAGG-1	T cells
ACCGTTCGTACAGTAA-1	Macrophages
ACCGTTCGTAGGAGTC-1	T cells
ACCGTTCTCATCCTGC-1	Endothelial cells
ACCTACCAGTAGCAAT-1	Fibroblasts
ACCTACCGTATACAGA-1	Fibroblasts
ACCTACCGTGTCCTAA-1	Epithelial cells
ACCTACCTCCACGAAT-1	Fibroblasts
ACCTGAACACTTCATT-1	DC
ACCTGAACAGCGCTTG-1	Monocytes
ACCTGTCAGGGCCAAT-1	Fibroblasts
ACCTGTCAGTACAGCG-1	DC
ACCTGTCCAAAGGGTC-1	T cells
ACCTGTCCAAGTGTCT-1	T cells
ACCTGTCCAATACGAA-1	Endothelial cells
ACCTGTCCACGAAGAC-1	Fibroblasts
ACCTGTCCATCACCAA-1	DC
ACCTGTCGTGAAGCTG-1	Fibroblasts
ACCTGTCGTGTGATGG-1	T cells
ACCTGTCTCTACTGAG-1	Epithelial cells
ACGATCAAGACGGATC-1	T cells
ACGATCAAGGCCTAAG-1	Fibroblasts
ACGATCAAGGTCGCCT-1	T cells
ACGATCAAGGTCGTAG-1	Fibroblasts
ACGATCACAATGAACA-1	Fibroblasts
ACGATCACATGGCTGC-1	Endothelial cells
ACGATCAGTCTTACTT-1	Fibroblasts
ACGATCAGTGGACTGA-1	Endothelial cells
ACGATCATCCAGCACG-1	T cells
ACGATCATCCGATAGT-1	Epithelial cells
ACGATCATCTAGTGTG-1	Epithelial cells
ACGATGTCACAAAGTA-1	Fibroblasts
ACGATGTCACCATTCC-1	T cells
ACGATGTGTCGTGGTC-1	T cells
ACGATGTGTGACTAAA-1	Fibroblasts
ACGATGTGTTTAAGGA-1	T cells
ACGATGTTCTGCTTAT-1	Monocytes
ACGCACGAGTTCACTG-1	Endothelial cells
ACGCACGCACTAGGCC-1	T cells
ACGCACGCAGTTGAAA-1	Fibroblasts
ACGCACGGTGCCGGTT-1	Epithelial cells
ACGCACGTCGCCTTTG-1	Endothelial cells
ACGCACGTCTTACGTT-1	T cells
ACGGAAGAGTAACCGG-1	Fibroblasts
ACGGAAGAGTGATCGG-1	Fibroblasts
ACGGAAGCAGAAGCTG-1	T cells
ACGGAAGCAGTCGTTA-1	T cells
ACGGAAGGTGGGTCAA-1	Fibroblasts
ACGGAAGTCTCATGGA-1	Mast cells
ACGGAAGTCTTGGATG-1	T cells
ACGGGTCCAAGAAACT-1	T cells
ACGGGTCGTCAAAGAT-1	Fibroblasts
ACGGGTCGTGGAATGC-1	Monocytes
ACGGTCGAGAGTTGAT-1	T cells
ACGGTCGCAAACACGG-1	Fibroblasts
ACGGTCGCACTAGTAC-1	Endothelial cells
ACGGTCGTCGCAGTGC-1	T cells
ACGGTTAAGCAGCACA-1	T cells
ACGGTTAAGGATACGC-1	DC
ACGGTTAAGGCGTCCT-1	Epithelial cells
ACGGTTACAATTGCCA-1	T cells
ACGGTTACATCGATAC-1	DC
ACGGTTAGTACGATCT-1	Fibroblasts
ACGGTTAGTCTACACA-1	T cells
ACGGTTAGTCTACAGT-1	Macrophages
ACGGTTAGTTAGAAGT-1	Endothelial cells
ACGGTTATCAGAGCAG-1	T cells
ACGGTTATCAGAGCGA-1	T cells
ACGTAACAGGAGGTTC-1	T cells
ACGTAACGTCCATCTC-1	T cells
ACGTAACTCAGAGTGG-1	ILC
ACGTACAAGGACTGGT-1	Fibroblasts
ACGTACACATACTGTG-1	Endothelial cells
ACGTACATCTGAGTCA-1	T cells
ACGTAGTAGCATATGA-1	T cells
ACGTAGTAGCTCCCTT-1	T cells
ACGTAGTAGGTAGTAT-1	Epithelial cells
ACGTAGTAGTGGTCAG-1	Fibroblasts
ACGTAGTCACCAGGTC-1	T cells
ACGTAGTCACCTGTCT-1	pDC
ACGTAGTCACGCGTGT-1	Fibroblasts
ACGTAGTTCAAGGACG-1	Fibroblasts
ACGTAGTTCCCATTTA-1	Endothelial cells
ACGTAGTTCCCGAACG-1	Epithelial cells
ACGTAGTTCGACATTG-1	Fibroblasts
ACGTAGTTCGCCACTT-1	T cells
ACGTCCTAGATGACCG-1	Epithelial cells
ACGTCCTAGCGTGTTT-1	T cells
ACGTCCTCACGGTGAA-1	NK cells
ACGTCCTGTACTGAGG-1	T cells
ACGTCCTGTCCGGTCA-1	Monocytes
ACGTCCTGTGGAACAC-1	DC
ACGTCCTGTTGCGTAT-1	Monocytes
ACGTCCTTCAGTGTTG-1	T cells
ACGTTCCAGCTCCACG-1	Fibroblasts
ACGTTCCAGCTCGACC-1	Fibroblasts
ACGTTCCCACCCTATC-1	T cells
ACGTTCCCAGAACATA-1	Monocytes
ACTACGAAGACATGCG-1	Fibroblasts
ACTACGAAGACGCCCT-1	Fibroblasts
ACTACGAAGAGTTGAT-1	Fibroblasts
ACTACGAAGCATATGA-1	Fibroblasts
ACTACGAAGCGCCCAT-1	Epithelial cells
ACTACGAGTAGACGGT-1	T cells
ACTACGAGTGCACATT-1	pDC
ACTACGAGTGTCACAT-1	Epithelial cells
ACTATCTAGATCGGTG-1	T cells
ACTATCTAGCATTGAA-1	T cells
ACTATCTAGCGGTATG-1	T cells
ACTATCTAGTGGTCAG-1	DC
ACTATCTCAACTTCTT-1	Fibroblasts
ACTATCTCAATTCGTG-1	Epithelial cells
ACTATCTCACCTGTCT-1	DC
ACTATCTCAGTGCCTG-1	Epithelial cells
ACTATCTGTGTATACC-1	Endothelial cells
ACTATCTGTTGCCAAT-1	T cells
ACTATCTTCCGTGTAA-1	T cells
ACTATGGAGAAGCCAC-1	T cells
ACTATGGAGGAGATAG-1	T cells
ACTATGGCAAATACGA-1	Plasma cells
ACTATGGGTTGTCTAG-1	Monocytes
ACTATGGTCACTTATC-1	DC
ACTATGGTCCGAACGC-1	Macrophages
ACTATGGTCGAACTCA-1	Epithelial cells
ACTATTCAGGGTCTTT-1	Fibroblasts
ACTCCCAAGATCGACG-1	Fibroblasts
ACTCCCAAGATGTAGT-1	T cells
ACTCCCAGTCTAACGT-1	Fibroblasts
ACTCCCAGTGGGACAT-1	T cells
ACTCCCATCTAGGCCG-1	T cells
ACTCTCGAGGGAGGTG-1	Fibroblasts
ACTCTCGGTACTGAGG-1	T cells
ACTCTCGGTATACCTG-1	Macrophages
ACTCTCGGTCGTTGCG-1	Fibroblasts
ACTCTCGTCATGGAGG-1	Fibroblasts
ACTCTCGTCCGTTTCG-1	Macrophages
ACTCTCGTCTTAGTTC-1	Epithelial cells
ACTGATGCAACAGAGC-1	Macrophages
ACTGATGCAGGTTCGC-1	T cells
ACTGATGTCGCCAACG-1	Epithelial cells
ACTGATGTCTGTCCGT-1	T cells
ACTGCAAAGAATCGAT-1	NK cells
ACTGCAACAGTAACAA-1	T cells
ACTGCAACATCAGTGT-1	ILC
ACTGCAAGTACAAGTA-1	T cells
ACTGCAATCAGCGCAC-1	DC
ACTGCAATCATCTGTT-1	Fibroblasts
ACTGCAATCTATTCGT-1	T cells
ACTGCAATCTGAGATC-1	T cells
ACTGTCCAGAGTGGCT-1	Epithelial cells
ACTGTCCAGCCATTGT-1	Monocytes
ACTGTCCAGTAGACAT-1	Epithelial cells
ACTGTCCCACCATAAC-1	T cells
ACTGTCCCATGGCTAT-1	NK cells
ACTGTCCGTCATGGCC-1	Fibroblasts
ACTGTCCGTTCGGCGT-1	B cells
ACTGTCCTCTGTCAGA-1	T cells
ACTGTGAAGTGGCCTC-1	DC
ACTGTGACACAGCCAC-1	Fibroblasts
ACTGTGACATGACCCG-1	Fibroblasts
ACTGTGAGTGATCGTT-1	T cells
ACTGTGATCAATCTTC-1	Epithelial cells
ACTGTGATCCCGAGGT-1	T cells
ACTGTGATCCCTCTAG-1	Epithelial cells
ACTTAGGAGAAGGTAG-1	Fibroblasts
ACTTAGGAGATGGGCT-1	Epithelial cells
ACTTAGGGTCCTTAAG-1	Epithelial cells
ACTTAGGGTGGCAACA-1	Epithelial cells
ACTTAGGTCGGTCATA-1	T cells
ACTTAGGTCTCAGTCC-1	T cells
ACTTATCCACTAAACC-1	Fibroblasts
ACTTATCGTAACATCC-1	T cells
ACTTATCGTCCTTTGC-1	Fibroblasts
ACTTATCTCAAGAGGC-1	Fibroblasts
ACTTCCGAGAGCAACC-1	Epithelial cells
ACTTCCGCAATAAGGT-1	Fibroblasts
ACTTCCGGTCACCCTT-1	Fibroblasts
ACTTCCGGTTCGGTTA-1	T cells
ACTTCCGTCAGTGCGC-1	T cells
ACTTCGCAGCAAGTCG-1	T cells
ACTTCGCAGGAATCGC-1	T cells
ACTTCGCCACATGTTG-1	Fibroblasts
ACTTCGCCACGTAGAG-1	Fibroblasts
ACTTCGCCAGAACCGA-1	Fibroblasts
ACTTCGCGTCCAGCCA-1	NK cells
ACTTTCAAGTAATCCC-1	Endothelial cells
ACTTTCACAATCCAGT-1	Epithelial cells
ACTTTCACACGGTCTG-1	DC
ACTTTCATCGCCAATA-1	Epithelial cells
ACTTTGTAGCACTGGA-1	Macrophages
ACTTTGTAGTCTTCCC-1	Mast cells
ACTTTGTCAAGTGTCT-1	Epithelial cells
ACTTTGTCACTCCTTG-1	DC
ACTTTGTCATGGAGAC-1	T cells
ACTTTGTGTTTCTTAC-1	Endothelial cells
ACTTTGTTCATACGGT-1	DC
AGAAATGAGATAGTCA-1	Fibroblasts
AGAAATGAGCCTCGTG-1	Epithelial cells
AGAAATGCACAAATAG-1	T cells
AGAAATGGTGTCTTAG-1	Fibroblasts
AGAAATGGTTGGTAGG-1	T cells
AGAAATGTCACCATGA-1	Plasma cells
AGAAATGTCATCGACA-1	T cells
AGAAATGTCCGAAATC-1	T cells
AGAAATGTCGATCCCT-1	Epithelial cells
AGAAATGTCGTGGGTC-1	Fibroblasts
AGAAATGTCTGCATAG-1	Monocytes
AGAACAAAGAATAGTC-1	T cells
AGAACAAGTGTCCTAA-1	Fibroblasts
AGAACAAGTTAATCGC-1	B cells
AGAACAAGTTCACGAT-1	NK cells
AGAACAAGTTTGTTGG-1	DC
AGAACAATCAGTGATC-1	T cells
AGAACAATCTCCGAAA-1	Monocytes
AGAACCTAGATAGTCA-1	Epithelial cells
AGAACCTAGCGCATCC-1	DC
AGAACCTCACACCTAA-1	Fibroblasts
AGAACCTCACTCCCTA-1	T cells
AGAACCTGTAGCCAGA-1	pDC
AGAACCTTCCAACCGG-1	NK cells
AGAACCTTCCCTATTA-1	T cells
AGAACCTTCTCACGAA-1	ILC
AGAAGCGCACAAACGG-1	T cells
AGAAGCGCAGACAATA-1	Fibroblasts
AGAAGCGGTCATATGC-1	Macrophages
AGAAGCGGTTTACGAC-1	T cells
AGAAGCGTCGGCACTG-1	Macrophages
AGAAGCGTCTCACTCG-1	T cells
AGAAGTAAGCATGGGT-1	Fibroblasts
AGAAGTAAGCCATTCA-1	T cells
AGAAGTAAGCCGATTT-1	Fibroblasts
AGAAGTAAGGGTCTTT-1	Fibroblasts
AGAAGTACACATATCG-1	Fibroblasts
AGAAGTACAGTAGGAC-1	Fibroblasts
AGAAGTAGTTAAACCC-1	T cells
AGAAGTAGTTAGAAGT-1	Macrophages
AGAAGTATCCCAGGCA-1	T cells
AGAAGTATCGCAATGT-1	Fibroblasts
AGACAAACAACAAGAT-1	Epithelial cells
AGACAAACAGTGTGGA-1	Monocytes
AGACAAAGTATCGTTG-1	T cells
AGACAAAGTCTACGTA-1	B cells
AGACAAATCACCCTGT-1	Epithelial cells
AGACAAATCACCCTTG-1	T cells
AGACAAATCCACAAGT-1	Fibroblasts
AGACACTAGGCGAACT-1	Epithelial cells
AGACACTCACCGAATT-1	T cells
AGACACTCACTACCCT-1	pDC
AGACACTCATACATCG-1	T cells
AGACACTCATCCGGCA-1	Epithelial cells
AGACACTGTACTAGCT-1	Fibroblasts
AGACACTGTTCACCGG-1	Endothelial cells
AGACACTTCGAGCCAC-1	T cells
AGACACTTCTTAATCC-1	T cells
AGACAGGCAAAGTATG-1	Fibroblasts
AGACAGGCAACTAGAA-1	T cells
AGACAGGCAAGCAGGT-1	T cells
AGACAGGTCCACGAAT-1	T cells
AGACAGGTCCGGACGT-1	Epithelial cells
AGACAGGTCGCCTAGG-1	Epithelial cells
AGACAGGTCTATACTC-1	T cells
AGACCATAGATGCAGC-1	T cells
AGACCATAGGATGTTA-1	Epithelial cells
AGACCATCAAACCACT-1	T cells
AGACCATCAGACACAG-1	Epithelial cells
AGACCATCATAGCTGT-1	Epithelial cells
AGACCATGTTATAGCC-1	DC
AGACCATTCCTGTAAG-1	Monocytes
AGACCCGCAGCGCTTG-1	Fibroblasts
AGACCCGCAGTTAAAG-1	Macrophages
AGACCCGCATCCAATG-1	Endothelial cells
AGACCCGTCCATCTCG-1	T cells
AGACTCAAGAAGTATC-1	Fibroblasts
AGACTCAAGCATTGAA-1	Fibroblasts
AGACTCAAGTAGCAAT-1	T cells
AGACTCACAAATAGCA-1	DC
AGACTCACAAGACCGA-1	Fibroblasts
AGACTCACACAGACGA-1	Epithelial cells
AGACTCACACCAGGTC-1	Epithelial cells
AGACTCACATTCACCC-1	Fibroblasts
AGACTCATCTACGGGC-1	Monocytes
AGACTCATCTTACTGT-1	Epithelial cells
AGAGAATAGCTTGTGT-1	T cells
AGAGAATAGTCCGTCG-1	Endothelial cells
AGAGAATAGTTTCGGT-1	Epithelial cells
AGAGAATTCGTAACAC-1	Endothelial cells
AGAGAATTCGTTCGCT-1	Monocytes
AGAGAGCAGGCCTGAA-1	T cells
AGAGCAGCAGGCCCTA-1	T cells
AGAGCAGGTCGAGTTT-1	T cells
AGAGCAGTCATGGCCG-1	Macrophages
AGAGCAGTCCGATTAG-1	T cells
AGAGCCCAGACGGTTG-1	NK cells
AGAGCCCAGCGACATG-1	Fibroblasts
AGAGCCCCAAAGCACG-1	Fibroblasts
AGAGCCCCACAGTGTT-1	Epithelial cells
AGAGCCCTCAACACGT-1	Epithelial cells
AGAGCCCTCACAGAGG-1	DC
AGAGCCCTCCTACGAA-1	NK cells
AGAGCCCTCTGAGGTT-1	Epithelial cells
AGATAGACAACCAACT-1	Epithelial cells
AGATAGACAGAGACTG-1	T cells
AGATAGAGTTGGGCCT-1	T cells
AGATAGATCATCGCAA-1	Fibroblasts
AGATAGATCCGTTTCG-1	T cells
AGATAGATCGTCTCAC-1	T cells
AGATCCAAGATGCTGG-1	Epithelial cells
AGATCCAAGGCAGTCA-1	T cells
AGATCCACACCGCTAG-1	Fibroblasts
AGATCCACAGAAACCG-1	T cells
AGATCCACATATCGGT-1	Endothelial cells
AGATCCAGTCACTAGT-1	Monocytes
AGATCCAGTCATGACT-1	Fibroblasts
AGATCCAGTTGCACGC-1	T cells
AGATCCATCCTACCGT-1	T cells
AGATCCATCGGACCAC-1	Monocytes
AGATCGTAGCCTGTCG-1	T cells
AGATCGTAGGTGCAGT-1	T cells
AGATCGTAGGTTCCGC-1	T cells
AGATCGTAGGTTTACC-1	T cells
AGATCGTCAAGGATGC-1	Fibroblasts
AGATCGTGTACTGTTG-1	Macrophages
AGATCGTGTTTACGAC-1	T cells
AGATCGTTCACGGAGA-1	T cells
AGATCGTTCATCAGTG-1	Fibroblasts
AGATCGTTCTAGCCTC-1	B cells
AGATCGTTCTTCGATT-1	Fibroblasts
AGATGAAAGAGGTATT-1	pDC
AGATGAAAGCTAGAGC-1	B cells
AGATGCTAGCACTCCG-1	Epithelial cells
AGATGCTAGTGACCTT-1	Fibroblasts
AGATGCTCAATAGAGT-1	T cells
AGATGCTCACAAGCAG-1	T cells
AGATGCTCAGGATCTT-1	Fibroblasts
AGATGCTGTTCAATCG-1	T cells
AGATGCTTCGTGCAGC-1	T cells
AGCATCAAGATCACTC-1	T cells
AGCATCAAGCTCCATA-1	pDC
AGCATCAAGGAACTCG-1	NK cells
AGCATCAAGGCAATGC-1	T cells
AGCATCACAAGACAAT-1	T cells
AGCATCACAGAGAAAG-1	T cells
AGCATCAGTAGACAGC-1	T cells
AGCATCAGTCCTGTCT-1	T cells
AGCATCAGTTGTATGC-1	Epithelial cells
AGCCAATAGGCCTAAG-1	DC
AGCCAATAGGGATGTC-1	T cells
AGCCAATAGTGAGTTA-1	Epithelial cells
AGCCAATCACATATGC-1	Fibroblasts
AGCCAATCACTGGATT-1	Macrophages
AGCCACGAGCTACAAA-1	T cells
AGCCACGGTAGCTTGT-1	DC
AGCCACGTCAATCAGC-1	T cells
AGCCACGTCAATCTCT-1	T cells
AGCCAGCAGCAGTACG-1	Fibroblasts
AGCCAGCAGTTGTCGT-1	Fibroblasts
AGCCAGCCATGCCGGT-1	Epithelial cells
AGCCAGCCATTGAAAG-1	Fibroblasts
AGCCAGCGTGACACGA-1	B cells
AGCCAGCGTGTGTTTG-1	T cells
AGCCAGCGTTATGTGC-1	T cells
AGCCAGCGTTTAAGGA-1	T cells
AGCCAGCTCAAACCTG-1	T cells
AGCCAGCTCACGATCA-1	Fibroblasts
AGCCAGCTCACGGAGA-1	NK cells
AGCGATTAGCGGTATG-1	Fibroblasts
AGCGATTAGCTGTACT-1	Epithelial cells
AGCGATTCAATTCGTG-1	Monocytes
AGCGATTCACATTCTT-1	Macrophages
AGCGATTCAGTTGGTT-1	Macrophages
AGCGATTGTAAGCTCT-1	B cells
AGCGATTGTCCCGTGA-1	Macrophages
AGCGATTTCCTACAAG-1	Fibroblasts
AGCGATTTCGAGATGG-1	T cells
AGCGATTTCTCGCGTT-1	T cells
AGCGCCAAGCAACCAG-1	Fibroblasts
AGCGCCACACGACAAG-1	Fibroblasts
AGCGCCATCCAGTACA-1	Endothelial cells
AGCGCTGAGCCTAACT-1	Monocytes
AGCGCTGCACCTATCC-1	Macrophages
AGCGCTGCATTGTGCA-1	Epithelial cells
AGCGCTGGTACGAGCA-1	Endothelial cells
AGCGCTGGTCGATTTG-1	Fibroblasts
AGCGCTGGTGTGCTTA-1	Macrophages
AGCGTATCAGGCAATG-1	Epithelial cells
AGCGTATGTACCGGAA-1	Macrophages
AGCGTATGTCCAAGAG-1	T cells
AGCGTATGTGGCGCTT-1	Fibroblasts
AGCGTCGAGAGTCAAT-1	T cells
AGCGTCGAGCACCTGC-1	T cells
AGCGTCGGTGACCGTC-1	Fibroblasts
AGCTACAAGACTGAGC-1	T cells
AGCTACAAGATGCCGA-1	Epithelial cells
AGCTACACAGCGTACC-1	T cells
AGCTACACAGGATTCT-1	Epithelial cells
AGCTACAGTGCCCGTA-1	T cells
AGCTACATCGGTCACG-1	DC
AGCTCAAAGTATCTGC-1	Epithelial cells
AGCTCAACACTGCATA-1	Fibroblasts
AGCTCAACAGAGGCAT-1	Epithelial cells
AGCTTCCAGACTCGAG-1	T cells
AGCTTCCAGGGATCAC-1	T cells
AGCTTCCAGTGATCGG-1	T cells
AGCTTCCCAAATGAGT-1	B cells
AGCTTCCTCACGATCA-1	T cells
AGGAAATCAAGTTCGT-1	Endothelial cells
AGGAAATCAATCTAGC-1	T cells
AGGAAATTCACCATCC-1	DC
AGGAAATTCACTTTGT-1	Fibroblasts
AGGAAATTCTCTGCTG-1	Fibroblasts
AGGAATAAGAAGCCAC-1	Fibroblasts
AGGAATAAGCGCATCC-1	Fibroblasts
AGGAATAAGCTACGTT-1	Epithelial cells
AGGAATACAGTTGTTG-1	B cells
AGGAATACATCGTCCT-1	Fibroblasts
AGGAATAGTATCTTCT-1	Fibroblasts
AGGAATATCGGCATAT-1	B cells
AGGAATATCTACTGAG-1	Fibroblasts
AGGACGAGTTCAATCG-1	Endothelial cells
AGGACGATCAAGAATG-1	T cells
AGGACGATCACTGTTT-1	T cells
AGGACGATCCGAAATC-1	Fibroblasts
AGGACTTCATTCAGGT-1	Fibroblasts
AGGACTTGTGCTGTCG-1	T cells
AGGACTTGTGGCTTGC-1	Epithelial cells
AGGACTTGTTGCGGCT-1	Fibroblasts
AGGACTTTCAACTGAC-1	T cells
AGGAGGTAGCAGCACA-1	T cells
AGGAGGTAGGAGTATT-1	Fibroblasts
AGGAGGTCACGAGAAC-1	Monocytes
AGGAGGTGTACACGTT-1	T cells
AGGAGGTGTACATACC-1	Epithelial cells
AGGAGGTGTCGTATTG-1	Epithelial cells
AGGAGGTGTTAAGTCC-1	T cells
AGGAGGTTCCGCTAGG-1	DC
AGGAGGTTCGGCCAAC-1	Epithelial cells
AGGAGGTTCTCCTGCA-1	pDC
AGGATAAAGCTCGTGC-1	Monocytes
AGGATAACACGACGCT-1	Endothelial cells
AGGATAAGTGACAGCA-1	T cells
AGGATAAGTGCCTATA-1	Endothelial cells
AGGATAATCACCCTTG-1	B cells
AGGATAATCATAGACC-1	Epithelial cells
AGGATAATCGATACAC-1	Fibroblasts
AGGATCTAGATTAGCA-1	T cells
AGGATCTAGTGTTCAC-1	Fibroblasts
AGGATCTAGTTAACGA-1	Plasma cells
AGGATCTCAGTCTACA-1	Endothelial cells
AGGATCTGTCTCACGG-1	DC
AGGATCTGTGGCTTAT-1	Plasma cells
AGGATCTGTTGCATTG-1	Fibroblasts
AGGATCTGTTTGGGAG-1	T cells
AGGATCTTCCGACATA-1	Fibroblasts
AGGCATTCACGACAGA-1	T cells
AGGCCACAGGCACCAA-1	Fibroblasts
AGGCCACAGTCATGCT-1	T cells
AGGCCACCAGGTACGA-1	Fibroblasts
AGGCCACTCAGTGATC-1	Fibroblasts
AGGCCACTCCCTCTCC-1	Fibroblasts
AGGCTGCAGCTGAGTG-1	Macrophages
AGGCTGCCAAACGGCA-1	T cells
AGGCTGCCAATTGAAG-1	Macrophages
AGGGAGTAGCTGTCCG-1	Fibroblasts
AGGGAGTAGGTAAGAG-1	pDC
AGGGAGTAGGTCTACT-1	Macrophages
AGGGAGTCAAGGTCTT-1	T cells
AGGGAGTCATCGGTTA-1	Fibroblasts
AGGGAGTGTAGATGTA-1	Endothelial cells
AGGGAGTTCGGTCGAC-1	Fibroblasts
AGGGCCTAGGGAGGTG-1	Fibroblasts
AGGGCCTCACACACGC-1	T cells
AGGGCCTGTAATCAGA-1	Fibroblasts
AGGGCCTTCAGATGCT-1	Endothelial cells
AGGGCCTTCCACAGGC-1	Macrophages
AGGGCCTTCCCTCAAC-1	T cells
AGGGCCTTCTAGAACC-1	T cells
AGGGCTCAGCACACCC-1	Fibroblasts
AGGGCTCAGCCATGCC-1	T cells
AGGGCTCAGCCTTCTC-1	Fibroblasts
AGGGCTCAGCTTAAGA-1	Fibroblasts
AGGGCTCCATAGGAGC-1	T cells
AGGGCTCTCCCAAGCG-1	Fibroblasts
AGGGCTCTCGAACGCC-1	Fibroblasts
AGGGCTCTCGATAACC-1	Epithelial cells
AGGGTCCAGTGGAAAG-1	T cells
AGGGTCCGTTACAGCT-1	B cells
AGGGTCCTCGATTGAC-1	Fibroblasts
AGGGTGACAGCGTTGC-1	Fibroblasts
AGGGTGACATGTTCGA-1	T cells
AGGGTGATCCGTGCGA-1	T cells
AGGGTTTAGCAACAGC-1	Monocytes
AGGGTTTAGGTTGTTC-1	Endothelial cells
AGGGTTTCAGCCGTCA-1	T cells
AGGGTTTGTGCCTTTC-1	T cells
AGGGTTTGTTTCGTAG-1	Epithelial cells
AGGGTTTTCGCTGACG-1	Fibroblasts
AGGTAGGAGCAGCACA-1	B cells
AGGTAGGAGTGGCAGT-1	Fibroblasts
AGGTAGGGTATAATGG-1	Fibroblasts
AGGTAGGTCCCAATAG-1	B cells
AGGTAGGTCGACATAC-1	Fibroblasts
AGGTAGGTCGTACCTC-1	Endothelial cells
AGGTAGGTCTTTCCAA-1	Fibroblasts
AGGTCATAGCACTCTA-1	Fibroblasts
AGGTCATAGGACATCG-1	Fibroblasts
AGGTCATAGTATTGCC-1	Epithelial cells
AGGTCATCAAGAATAC-1	Macrophages
AGGTCATGTTGTGCCG-1	Fibroblasts
AGGTCATTCCATAAGC-1	Epithelial cells
AGGTCTAAGATCGACG-1	Monocytes
AGGTCTAAGGGTCACA-1	Endothelial cells
AGGTCTACACAGCGCT-1	Epithelial cells
AGGTCTAGTACACTCA-1	ILC
AGGTCTAGTATGGAAT-1	Endothelial cells
AGGTCTAGTGATATAG-1	T cells
AGGTCTATCAACTGAC-1	Fibroblasts
AGGTCTATCCCATTTA-1	T cells
AGGTGTTGTCGCTGCA-1	T cells
AGGTGTTGTTAGAAGT-1	Monocytes
AGGTTACAGTGCAAAT-1	Plasma cells
AGGTTACAGTTCCTGA-1	Epithelial cells
AGGTTACGTGCGAGTA-1	Fibroblasts
AGGTTACGTGGCAACA-1	Epithelial cells
AGGTTACGTGTTCCAA-1	T cells
AGGTTACTCACAGTGT-1	NK cells
AGGTTGTAGGTGAGCT-1	Epithelial cells
AGGTTGTCACGAGGTA-1	T cells
AGGTTGTGTAGATTGA-1	Fibroblasts
AGTAACCAGTTGCTGT-1	T cells
AGTAACCCACACCTGG-1	Monocytes
AGTAACCGTAGGCAGT-1	Monocytes
AGTAACCGTGGCTGAA-1	T cells
AGTAACCGTGTTTACG-1	NK cells
AGTAACCGTTCCAGGC-1	Fibroblasts
AGTAACCTCAATCCGA-1	Epithelial cells
AGTAACCTCACCTTAT-1	Fibroblasts
AGTAACCTCTAAGCCA-1	T cells
AGTACCAAGTAGGCCA-1	Fibroblasts
AGTACCACATAGGTAA-1	Endothelial cells
AGTACCACATCGTGGC-1	Fibroblasts
AGTACCAGTGTTAGCT-1	Fibroblasts
AGTACCAGTTACCCTC-1	NK cells
AGTACCATCCTTCAGC-1	Endothelial cells
AGTACTGCAAGCGAAC-1	Epithelial cells
AGTACTGCAGTATACC-1	Fibroblasts
AGTACTGGTATGTCTG-1	Epithelial cells
AGTACTGGTCGCATTA-1	Epithelial cells
AGTACTGGTGACCTGC-1	T cells
AGTACTGGTGCGGTAA-1	B cells
AGTACTGGTTTCGGCG-1	Endothelial cells
AGTACTGTCGTCAGAT-1	Fibroblasts
AGTAGCTAGCCAGACA-1	ILC
AGTAGCTAGTTGCATC-1	Fibroblasts
AGTAGCTCAAGGGTCA-1	Fibroblasts
AGTAGCTCACCTGCTT-1	Monocytes
AGTAGCTGTCCATACA-1	T cells
AGTAGCTTCACTTTGT-1	Macrophages
AGTAGCTTCCATGAGT-1	Fibroblasts
AGTAGCTTCGACCATA-1	ILC
AGTAGTCAGACCTTTG-1	Epithelial cells
AGTAGTCAGTTGGACG-1	Fibroblasts
AGTAGTCCAATCGCCG-1	Endothelial cells
AGTAGTCCAGATCCTA-1	T cells
AGTAGTCGTCATGGCC-1	T cells
AGTAGTCTCGAGGCAA-1	Endothelial cells
AGTAGTCTCTTGAACG-1	T cells
AGTCAACCAGACACAG-1	Mast cells
AGTCAACGTGGCGCTT-1	Fibroblasts
AGTCAACGTGGGAGAG-1	Epithelial cells
AGTCAACTCCGCACTT-1	Epithelial cells
AGTCACAAGCATGGGT-1	T cells
AGTCACAAGTCGTCTA-1	Fibroblasts
AGTCACACAGCATTGT-1	T cells
AGTCACAGTCAAAGCG-1	Monocytes
AGTCACAGTGTGCCTG-1	T cells
AGTCATGAGACCGTTT-1	Monocytes
AGTCATGAGCCGTTGC-1	NK cells
AGTCATGAGTAGCAAT-1	Fibroblasts
AGTCATGCAAATCGTC-1	Fibroblasts
AGTCATGCAATGCTCA-1	Fibroblasts
AGTCATGGTACTGCCG-1	Macrophages
AGTCATGGTTCCATTT-1	T cells
AGTCATGTCGCCAATA-1	Epithelial cells
AGTCATGTCTGCTTAT-1	T cells
AGTCATGTCTTCGGAA-1	Epithelial cells
AGTCTCCCACTCCTGT-1	T cells
AGTCTCCCATCAACCA-1	T cells
AGTCTCCTCCGACGGT-1	T cells
AGTCTCCTCCTCTAAT-1	Epithelial cells
AGTGACTAGGAGAGGC-1	Fibroblasts
AGTGACTAGGGCAAGG-1	T cells
AGTGACTAGTCACTCA-1	Fibroblasts
AGTGACTCAGTCGTTA-1	Fibroblasts
AGTGACTCATGATCTG-1	Endothelial cells
AGTGACTTCGTGAGAG-1	Mast cells
AGTGACTTCTATCCAT-1	T cells
AGTGACTTCTGGGCAC-1	Fibroblasts
AGTGATCAGCCTCAAT-1	Fibroblasts
AGTGATCCAATTTCCT-1	Fibroblasts
AGTGATCTCCGTCCTA-1	Epithelial cells
AGTGATCTCTGGAGAG-1	Epithelial cells
AGTGCCGAGGGAGGTG-1	Macrophages
AGTGCCGAGGTCATTC-1	T cells
AGTGCCGCAATAGTAG-1	Fibroblasts
AGTGCCGCACAGCGCT-1	Epithelial cells
AGTGCCGCACATTCGA-1	Fibroblasts
AGTGCCGCATACAGAA-1	Fibroblasts
AGTGCCGGTCCAGAAG-1	Fibroblasts
AGTGCCGGTGTACAGG-1	Macrophages
AGTGCCGGTTTGTGGT-1	Fibroblasts
AGTGCCGTCAAGCCCG-1	Fibroblasts
AGTGCCGTCCGCGATG-1	Monocytes
AGTGTTGGTTGCCATA-1	T cells
AGTGTTGTCTAGCCAA-1	Epithelial cells
AGTTAGCAGGTGGCTA-1	Epithelial cells
AGTTAGCAGTGTTGTC-1	Fibroblasts
AGTTAGCCATATACCG-1	Fibroblasts
AGTTAGCGTTCTAAGC-1	Fibroblasts
AGTTAGCTCCGCGGAT-1	T cells
AGTTAGCTCGGCTATA-1	T cells
AGTTAGCTCGTACCTC-1	T cells
AGTTAGCTCTTGGAAC-1	T cells
AGTTCCCAGCGAATGC-1	T cells
AGTTCCCAGGGTACGT-1	Endothelial cells
AGTTCCCCAAACTCTG-1	pDC
AGTTCCCCAAAGAACT-1	Epithelial cells
AGTTCCCCACGGCCAT-1	Monocytes
AGTTCCCCAGCGACCT-1	Monocytes
AGTTCCCCATGACAAA-1	T cells
AGTTCCCGTGAAAGTT-1	Fibroblasts
AGTTCCCGTGAGATAT-1	Macrophages
AGTTCCCGTTGCATAC-1	B cells
AGTTCGAAGAAAGCGA-1	Epithelial cells
AGTTCGACACGGCGTT-1	Fibroblasts
AGTTCGACACTGTGTA-1	Fibroblasts
AGTTCGAGTTTCGATG-1	DC
AGTTCGATCATAAGGA-1	Monocytes
AGTTCGATCATTACCT-1	T cells
AGTTCGATCCAAGCAT-1	pDC
ATACCGAAGACCATTC-1	Fibroblasts
ATACCGAAGCCTTGAT-1	T cells
ATACCGACAAACACGG-1	Fibroblasts
ATACCGACAACCGCTG-1	B cells
ATACCGAGTAGCGTAG-1	T cells
ATACCGAGTAGGCAGT-1	Monocytes
ATACCGATCACAGTGT-1	Fibroblasts
ATACCGATCAGCATTG-1	T cells
ATACCGATCGAAGGAC-1	Epithelial cells
ATACCTTCAGCGACCT-1	Fibroblasts
ATACCTTCAGTATTCG-1	T cells
ATACCTTGTAACGCGA-1	T cells
ATACTTCAGACGACGT-1	T cells
ATACTTCAGATGGGCT-1	Monocytes
ATACTTCAGCAACTCT-1	Macrophages
ATACTTCTCAACGTGT-1	T cells
ATACTTCTCAGAGCAG-1	Epithelial cells
ATACTTCTCAGCTCTC-1	T cells
ATAGACCCAACACGAG-1	Fibroblasts
ATAGACCCAACCACGC-1	B cells
ATAGACCCAAGGATGC-1	T cells
ATAGACCCACACGTGC-1	T cells
ATAGACCCAGCTTTCC-1	T cells
ATAGACCCATCCGAGC-1	Epithelial cells
ATAGACCGTGAGCAGT-1	Endothelial cells
ATAGACCGTTCGGCTG-1	T cells
ATAGACCTCGCATTGA-1	T cells
ATAGAGAAGAGTTGAT-1	T cells
ATAGAGAAGGCTAAAT-1	Fibroblasts
ATAGAGAAGTCATCGT-1	Macrophages
ATAGAGACACTTTAGG-1	Epithelial cells
ATAGAGACAGGAATCG-1	T cells
ATAGAGAGTAGTTCCA-1	Epithelial cells
ATAGAGAGTCGGAACA-1	Endothelial cells
ATAGAGAGTGTGCTTA-1	T cells
ATAGAGAGTTACGCCG-1	Monocytes
ATAGAGATCAACCGAT-1	Epithelial cells
ATAGAGATCAAGAGTA-1	T cells
ATAGAGATCGCCGATG-1	Fibroblasts
ATAGAGATCGTTCTGC-1	pDC
ATAGAGATCTCTATAC-1	Monocytes
ATAGAGATCTGTGCAA-1	Epithelial cells
ATAGGCTCACTCAAGT-1	B cells
ATAGGCTCAGTTGTCA-1	Fibroblasts
ATATCCTAGGACTTCT-1	Fibroblasts
ATATCCTGTACAATAG-1	Epithelial cells
ATATCCTTCTCCTGAC-1	Mast cells
ATATCCTTCTCGCTCA-1	Monocytes
ATCACAGAGAAGGTAG-1	Fibroblasts
ATCACAGAGCGCGTTC-1	DC
ATCACAGAGCGTGAGT-1	T cells
ATCACAGGTCTGTGTA-1	Epithelial cells
ATCACAGTCAAGTGGG-1	NK cells
ATCACAGTCACGGGAA-1	T cells
ATCACAGTCATCTACT-1	Fibroblasts
ATCACAGTCCACGGGT-1	ILC
ATCACAGTCCATCGTC-1	Endothelial cells
ATCACGAAGGGAGAAT-1	T cells
ATCACGACACTGCATA-1	T cells
ATCACGAGTCAGGTGA-1	T cells
ATCACGATCCACGTAA-1	T cells
ATCACTTAGGGCTGAT-1	Epithelial cells
ATCACTTCATAATCGC-1	Fibroblasts
ATCACTTTCAGTCATG-1	NK cells
ATCACTTTCCCTTGGT-1	Epithelial cells
ATCACTTTCGTCTACC-1	Fibroblasts
ATCACTTTCTGGTCAA-1	Fibroblasts
ATCACTTTCTTGTGCC-1	T cells
ATCAGGTAGCGACTTT-1	Fibroblasts
ATCAGGTCAAGTGGAC-1	Epithelial cells
ATCAGGTCAATGCAGG-1	Fibroblasts
ATCAGGTCACAAATGA-1	T cells
ATCAGGTGTGATCATC-1	Monocytes
ATCATTCGTAACGTTC-1	T cells
ATCATTCTCAGCTGTA-1	pDC
ATCCACCAGAACTGAT-1	T cells
ATCCACCAGGATCATA-1	T cells
ATCCACCCAAACAGGC-1	Endothelial cells
ATCCACCCACCTGCTT-1	Fibroblasts
ATCCACCCAGCAGGAT-1	Epithelial cells
ATCCACCGTCGTGTTA-1	Epithelial cells
ATCCACCGTCTTCCGT-1	DC
ATCCACCGTGTGCCTG-1	DC
ATCCACCTCCACAGGC-1	Macrophages
ATCCATTGTGGCTTAT-1	Epithelial cells
ATCCATTGTGTTCGAT-1	Fibroblasts
ATCCATTTCATCCTAT-1	pDC
ATCCATTTCATGAGGG-1	Epithelial cells
ATCCATTTCATGTCAG-1	T cells
ATCCATTTCCACGTGG-1	Epithelial cells
ATCCATTTCCCGAGTG-1	Monocytes
ATCCATTTCTAGTACG-1	Fibroblasts
ATCCCTGAGAGAGGTA-1	T cells
ATCCCTGAGCCTCAGC-1	Monocytes
ATCCCTGCAAGATGGC-1	T cells
ATCCCTGGTCCCTCAT-1	Fibroblasts
ATCCCTGGTTAGGAGC-1	Monocytes
ATCCCTGTCGCATGAT-1	Epithelial cells
ATCCCTGTCGTAGTGT-1	T cells
ATCCGTCAGACCAAAT-1	Fibroblasts
ATCCGTCAGCAATAGT-1	Macrophages
ATCCGTCCAACGACAG-1	T cells
ATCCGTCCAACGCCCA-1	T cells
ATCCGTCCAACTCCAA-1	T cells
ATCCGTCCAGATACCT-1	Fibroblasts
ATCCGTCCAGGCACAA-1	Fibroblasts
ATCCGTCGTCGTGCCA-1	DC
ATCCGTCGTTAGAGTA-1	Fibroblasts
ATCCGTCTCCAAACCA-1	Monocytes
ATCCGTCTCTCTCGAC-1	Fibroblasts
ATCCTATAGCATGTTC-1	Epithelial cells
ATCCTATAGTAGTCCT-1	DC
ATCCTATCAGTAGTTC-1	B cells
ATCCTATTCACTTTGT-1	Fibroblasts
ATCCTATTCTCCGATC-1	B cells
ATCCTATTCTGATTCT-1	Epithelial cells
ATCGATGAGCCGTTGC-1	Monocytes
ATCGATGGTAGCACAG-1	Epithelial cells
ATCGATGTCGAATGCT-1	Fibroblasts
ATCGCCTAGAGGGTGG-1	T cells
ATCGCCTAGCCTCATA-1	Fibroblasts
ATCGCCTAGCGTCTGC-1	Fibroblasts
ATCGCCTAGTATAGAC-1	Endothelial cells
ATCGCCTAGTGCAGCA-1	Fibroblasts
ATCGCCTAGTTACGGG-1	Fibroblasts
ATCGCCTCAGAGGTTG-1	Monocytes
ATCGGATAGACCAAGC-1	Fibroblasts
ATCGGATCAAACTCGT-1	T cells
ATCGGATCAACGCATT-1	T cells
ATCGGATCAATCCAGT-1	Fibroblasts
ATCGGATGTCGTCTCT-1	T cells
ATCGGATTCCGTGCGA-1	T cells
ATCGGCGAGAAGTCTA-1	Monocytes
ATCGGCGAGAGGCCAT-1	Macrophages
ATCGGCGAGCGAACTG-1	Monocytes
ATCGGCGAGTATAGAC-1	Fibroblasts
ATCGGCGCAAGCACCC-1	Fibroblasts
ATCGGCGCATCGTCCT-1	Fibroblasts
ATCGGCGGTACGATCT-1	Monocytes
ATCGGCGGTAGGGAGG-1	Epithelial cells
ATCGGCGGTCATGCAT-1	Fibroblasts
ATCGTAGAGATTGAGT-1	T cells
ATCGTAGAGCCTGAAG-1	Epithelial cells
ATCGTAGAGCTAGCCC-1	T cells
ATCGTAGAGTCTTCCC-1	Epithelial cells
ATCGTAGCAAGCGATG-1	Fibroblasts
ATCGTAGCACGGTAGA-1	Epithelial cells
ATCGTAGGTCAAGCCC-1	Plasma cells
ATCGTAGGTTAGGACG-1	T cells
ATCGTAGGTTCTCACC-1	NK cells
ATCGTAGTCAGCCTCT-1	Epithelial cells
ATCGTAGTCCTGTTGC-1	Monocytes
ATCGTAGTCGTCGCTT-1	T cells
ATCGTAGTCTAACACG-1	Monocytes
ATCGTCCAGCACCGAA-1	Fibroblasts
ATCGTCCAGGGACAGG-1	T cells
ATCGTCCGTAGGAGGG-1	NK cells
ATCGTGAAGCATTTCG-1	Fibroblasts
ATCGTGAAGCCTCCAG-1	T cells
ATCGTGAGTCAGACGA-1	T cells
ATCGTGAGTCCGATCG-1	Fibroblasts
ATCGTGAGTCTGCAAT-1	DC
ATCTCTAAGAGGCTGT-1	Monocytes
ATCTCTAAGCACTCAT-1	Epithelial cells
ATCTCTAGTCCGGTGT-1	Endothelial cells
ATCTCTAGTGGGAGAG-1	DC
ATCTTCAAGACTCGAG-1	DC
ATCTTCAAGATTACCC-1	Epithelial cells
ATCTTCAAGTTTGTCG-1	T cells
ATCTTCACAGAGTTCT-1	T cells
ATCTTCAGTAGATCCT-1	Monocytes
ATCTTCAGTCGTTTCC-1	Fibroblasts
ATGAAAGAGAAATGGG-1	Fibroblasts
ATGAAAGAGTCGTTAC-1	Epithelial cells
ATGAAAGAGTGCGCTC-1	Fibroblasts
ATGAAAGCACCGTACG-1	Fibroblasts
ATGAAAGCACTTCAAG-1	Macrophages
ATGAAAGGTCTACGTA-1	Fibroblasts
ATGAAAGTCGTCGCTT-1	Epithelial cells
ATGAAAGTCTTCCAGC-1	Fibroblasts
ATGACCAAGGCCTGAA-1	B cells
ATGACCAAGGTGCCAA-1	T cells
ATGACCAAGTAGACAT-1	T cells
ATGACCAAGTGCCCGT-1	Monocytes
ATGACCACAGAGTAAT-1	Fibroblasts
ATGACCAGTCCTCCAT-1	Epithelial cells
ATGACCAGTGACACGA-1	NK cells
ATGACCATCGAGGCAA-1	T cells
ATGACCATCGGTTGTA-1	Fibroblasts
ATGACCATCTTCGCTG-1	NK cells
ATGAGGGAGCTTTGTG-1	ILC
ATGAGGGAGGAAAGAC-1	Endothelial cells
ATGAGGGAGTGTCATC-1	Fibroblasts
ATGAGGGCATCGCCTT-1	Monocytes
ATGAGTCAGTTTGAGA-1	B cells
ATGAGTCTCAAGCGTT-1	DC
ATGATCGAGCGTTAGG-1	Fibroblasts
ATGATCGAGGATATAC-1	T cells
ATGATCGCATTCCTCG-1	Epithelial cells
ATGATCGGTATTTCGG-1	T cells
ATGATCGTCCTAAACG-1	T cells
ATGATCGTCGGTCTGG-1	Fibroblasts
ATGCATGAGACAACTA-1	Fibroblasts
ATGCATGCAATAACCC-1	T cells
ATGCATGCAGTCAGTT-1	Epithelial cells
ATGCATGCATAGACTC-1	Fibroblasts
ATGCATGGTATATGGA-1	T cells
ATGCATGGTATCGCTA-1	Fibroblasts
ATGCATGGTGTTAACC-1	Fibroblasts
ATGCATGTCAATCCAG-1	Fibroblasts
ATGCATGTCACCATCC-1	T cells
ATGCATGTCGACGCTG-1	T cells
ATGCATGTCTCTGCCA-1	NK cells
ATGCATGTCTTTACAC-1	Fibroblasts
ATGCCTCCACCATTCC-1	T cells
ATGCCTCCATATGAAG-1	T cells
ATGCCTCCATGAATAG-1	Macrophages
ATGCCTCCATGGAGAC-1	B cells
ATGCCTCGTCACTTCC-1	Fibroblasts
ATGCCTCTCATTACTC-1	T cells
ATGCGATAGACTCAAA-1	T cells
ATGCGATAGAGCTGAC-1	Plasma cells
ATGCGATGTTGTCAGT-1	Fibroblasts
ATGCGATGTTTGGGAG-1	Epithelial cells
ATGCGATTCACCTCTG-1	DC
ATGCGATTCAGAACCT-1	T cells
ATGCGATTCATTTACC-1	T cells
ATGCGATTCTACACAG-1	T cells
ATGGAGGAGAAATTGC-1	Fibroblasts
ATGGAGGCACTGAGGA-1	NK cells
ATGGAGGCATGACTAC-1	Fibroblasts
ATGGAGGGTATACCCA-1	DC
ATGGAGGGTTGCTTGA-1	Epithelial cells
ATGGAGGTCGTCAACA-1	Monocytes
ATGGATCAGATCGACG-1	Fibroblasts
ATGGATCAGCAGCGAT-1	Monocytes
ATGGATCCAGAATTCC-1	Endothelial cells
ATGGATCGTAATTGGA-1	pDC
ATGGATCGTCATCGGC-1	Fibroblasts
ATGGATCGTGAATATG-1	Epithelial cells
ATGGATCTCATCACCC-1	Fibroblasts
ATGGATCTCTGGACTA-1	DC
ATGGGAGAGCTGAGTG-1	Fibroblasts
ATGGGAGCAAATAAGC-1	Fibroblasts
ATGGGAGTCAATCAGC-1	Fibroblasts
ATGGGTTAGAGTATAC-1	T cells
ATGGGTTAGCATAGGC-1	T cells
ATGGGTTAGCCATTGT-1	Fibroblasts
ATGGGTTAGGGTGGGA-1	Epithelial cells
ATGGGTTCAAGTGGCA-1	Fibroblasts
ATGGGTTCATTGACCA-1	Epithelial cells
ATGGGTTGTGCGACAA-1	T cells
ATGGGTTGTGTCATCA-1	T cells
ATGGTTGAGGGTCTTT-1	T cells
ATGGTTGCACTCTGCT-1	T cells
ATGGTTGGTGGTAACG-1	Fibroblasts
ATGGTTGTCAGCGCAC-1	Macrophages
ATGTCCCAGAAGTCCG-1	B cells
ATGTCCCAGGATAATC-1	T cells
ATGTCCCAGTCCGCGT-1	T cells
ATGTCCCAGTGCTCGC-1	T cells
ATGTCCCGTGAATTAG-1	Fibroblasts
ATGTCCCTCACTGCTC-1	Fibroblasts
ATGTCCCTCCTAACAG-1	T cells
ATGTCTTAGGCACGAT-1	Fibroblasts
ATGTCTTAGGTTCCAT-1	Fibroblasts
ATGTCTTAGTGCACCC-1	T cells
ATGTCTTCAACAGATA-1	T cells
ATGTCTTCAGCACAGA-1	Epithelial cells
ATGTCTTGTCCCTCAT-1	Monocytes
ATGTCTTGTTTCGTAG-1	Macrophages
ATGTCTTTCATGTCAG-1	Fibroblasts
ATGTCTTTCCAAGAGG-1	Fibroblasts
ATGTCTTTCCTGGGTG-1	Monocytes
ATTACCTAGCTGGCTC-1	ILC
ATTACCTAGGCCCGTT-1	Epithelial cells
ATTACCTAGTGGACTG-1	ILC
ATTACCTAGTTAGTGA-1	Epithelial cells
ATTACCTCAGCTGTCG-1	Monocytes
ATTACCTCAGTTTGGT-1	T cells
ATTACCTCATGACTCA-1	Epithelial cells
ATTACCTGTTTAGACC-1	Endothelial cells
ATTACCTTCGTTCTCG-1	Macrophages
ATTACTCCAGTCAACT-1	Epithelial cells
ATTACTCCATGGGCAA-1	Fibroblasts
ATTACTCGTACCGCGT-1	Endothelial cells
ATTACTCGTGTTTCTT-1	Fibroblasts
ATTACTCGTTGGGCCT-1	Epithelial cells
ATTACTCTCATGCCAA-1	T cells
ATTACTCTCTATTGTC-1	T cells
ATTATCCAGGTACTGG-1	Monocytes
ATTATCCAGTGCACTT-1	Fibroblasts
ATTATCCGTCTACTGA-1	Endothelial cells
ATTATCCGTGGGACAT-1	pDC
ATTATCCGTGTGCCTG-1	Fibroblasts
ATTATCCTCACATTGG-1	ILC
ATTATCCTCCCTAGGG-1	Fibroblasts
ATTATCCTCCTAGAGT-1	NK cells
ATTATCCTCGTTCTAT-1	B cells
ATTCACTAGGATATGT-1	Epithelial cells
ATTCACTCAGCTCTGG-1	Monocytes
ATTCACTCAGTTCCAA-1	DC
ATTCACTGTATGCGTT-1	T cells
ATTCACTGTTAGAGTA-1	Epithelial cells
ATTCACTTCATAGGCT-1	Fibroblasts
ATTCACTTCCTCTCTT-1	Fibroblasts
ATTCAGGCAACGGTAG-1	Monocytes
ATTCAGGCACGTGTGC-1	Epithelial cells
ATTCAGGCACTTCTCG-1	T cells
ATTCAGGTCACGAACT-1	T cells
ATTCAGGTCCACCCTA-1	Epithelial cells
ATTCAGGTCCATTGCC-1	Fibroblasts
ATTCAGGTCGACCCAG-1	Fibroblasts
ATTCAGGTCTCTCTTC-1	Fibroblasts
ATTCAGGTCTGACCCT-1	Fibroblasts
ATTCATCAGAGGTTTA-1	Epithelial cells
ATTCATCAGCAACTCT-1	T cells
ATTCATCAGTCATCGT-1	Fibroblasts
ATTCATCCAGTTAGGG-1	T cells
ATTCATCGTTGGCTAT-1	Fibroblasts
ATTCATCTCGGATAAA-1	T cells
ATTCCATAGAAACACT-1	Epithelial cells
ATTCCATCAAGATGGC-1	T cells
ATTCCATGTAGTCCTA-1	B cells
ATTCCATGTTTCGTGA-1	ILC
ATTCCATTCGCTGTTC-1	Epithelial cells
ATTCCCGCAAGAGTGC-1	B cells
ATTCCCGCAAGCCCAC-1	Fibroblasts
ATTCCCGGTAGTAAGT-1	Macrophages
ATTCCCGGTGCAATGG-1	Fibroblasts
ATTCCCGTCTAGTGAC-1	T cells
ATTCCCGTCTTTCTAG-1	NK cells
ATTCCTAAGGCAGTCA-1	B cells
ATTCCTAGTACAAACA-1	T cells
ATTCCTAGTATCTCTT-1	Macrophages
ATTCCTATCTACACAG-1	T cells
ATTCCTATCTCCAATT-1	T cells
ATTCGTTAGAGTTCGG-1	pDC
ATTCGTTCAAGTGATA-1	Epithelial cells
ATTCGTTCAGACCTGC-1	Monocytes
ATTCGTTCAGGCATGA-1	T cells
ATTCGTTCATAACCCA-1	T cells
ATTCTACCAAGGTCGA-1	Monocytes
ATTCTACCACGACCTG-1	Fibroblasts
ATTCTACGTAGCCCTG-1	T cells
ATTCTACGTCTGCGCA-1	T cells
ATTCTACGTTAGGGAC-1	T cells
ATTCTACGTTCAATCG-1	Epithelial cells
ATTCTACTCAAACCCA-1	Epithelial cells
ATTCTACTCACGGACC-1	Epithelial cells
ATTCTACTCTACCCAC-1	T cells
ATTCTACTCTGCACCT-1	Fibroblasts
ATTCTACTCTTCGCTG-1	T cells
ATTCTTGAGGGCAGTT-1	Endothelial cells
ATTCTTGTCCGTGGGT-1	Epithelial cells
ATTCTTGTCTCTCTAA-1	Epithelial cells
ATTGGGTAGACCCTTA-1	T cells
ATTGGGTAGATTGACA-1	T cells
ATTGGGTAGCCGATCC-1	Macrophages
ATTGGGTCACGCAAAG-1	Epithelial cells
ATTGGGTGTCGGAACA-1	T cells
ATTGGGTTCAGCAATC-1	Fibroblasts
ATTGGGTTCAGCTAGT-1	T cells
ATTGTTCAGCGTCTCG-1	T cells
ATTGTTCAGGTTCAGG-1	Fibroblasts
ATTGTTCCACACACGC-1	Fibroblasts
ATTGTTCCACGCGCTA-1	Fibroblasts
ATTGTTCCACTACGGC-1	T cells
ATTGTTCGTTCCGCGA-1	Monocytes
ATTGTTCTCTGTTCAT-1	Monocytes
ATTTACCAGGATGAGA-1	Fibroblasts
ATTTACCCACGTCTCT-1	T cells
ATTTACCCAGATCCTA-1	T cells
ATTTACCGTCCGACGT-1	Fibroblasts
ATTTACCGTGAGACCA-1	B cells
ATTTACCGTGTCTTCC-1	Fibroblasts
ATTTACCGTTGCGGAA-1	T cells
ATTTCACAGGTTGACG-1	Endothelial cells
ATTTCACCAACAGCTT-1	Macrophages
ATTTCACCAGGAAGTC-1	Fibroblasts
ATTTCACGTGACAACG-1	T cells
ATTTCACGTGACCGAA-1	Fibroblasts
ATTTCACGTGTCTAAC-1	T cells
ATTTCACGTGTTGATC-1	Fibroblasts
ATTTCACTCGTTATCT-1	Epithelial cells
ATTTCACTCTCGTCAC-1	Epithelial cells
ATTTCTGCACTACACA-1	Fibroblasts
ATTTCTGCATAGCTGT-1	T cells
ATTTCTGGTTGCGGCT-1	ILC
ATTTCTGTCCGTGTGG-1	Fibroblasts
ATTTCTGTCCTTCAGC-1	T cells
CAAAGAAAGATCACTC-1	T cells
CAAAGAAAGTGTCATC-1	T cells
CAAAGAACACTGAGTT-1	T cells
CAAAGAAGTGCTCGTG-1	T cells
CAAAGAATCTTCCAGC-1	Fibroblasts
CAACAACAGACTAAGT-1	Epithelial cells
CAACAACAGCTACTGT-1	Endothelial cells
CAACAACCACACGGTC-1	B cells
CAACAACGTCTCAGAT-1	Epithelial cells
CAACAGTAGTATGACA-1	T cells
CAACAGTAGTGCAGCA-1	Monocytes
CAACAGTGTACGTGTT-1	pDC
CAACAGTGTCCTACAA-1	Fibroblasts
CAACCAAAGCACCCAC-1	Monocytes
CAACCAAAGGCCGCTT-1	Fibroblasts
CAACCAACAACACACT-1	Fibroblasts
CAACCAAGTCTGTGAT-1	DC
CAACCAAGTTGCTAGT-1	ILC
CAACCTCCAGTCTGGC-1	Fibroblasts
CAACCTCCATGGGTCC-1	Plasma cells
CAACCTCGTTCGGTCG-1	Epithelial cells
CAACCTCTCACTGTTT-1	Fibroblasts
CAACCTCTCCGTCACT-1	Fibroblasts
CAACGATAGATGACCG-1	T cells
CAACGATAGCGTTCCG-1	T cells
CAACGATAGTGGACTG-1	Fibroblasts
CAACGATGTGCCCAGT-1	T cells
CAACGATGTTGCTTGA-1	Epithelial cells
CAACGATTCATCCTGC-1	Epithelial cells
CAACGGCAGATGTTAG-1	Epithelial cells
CAACGGCCACGAGGTA-1	Macrophages
CAACGGCCATCTTCGC-1	T cells
CAACGGCCATTCGATG-1	Fibroblasts
CAACGGCGTTCTCGTC-1	Epithelial cells
CAACGGCTCAGGAAGC-1	T cells
CAACGGCTCCATCACC-1	T cells
CAACGGCTCTCTCGAC-1	Fibroblasts
CAACGGCTCTGATGGT-1	Fibroblasts
CAAGACTAGAAACTGT-1	Fibroblasts
CAAGACTAGAGTCAAT-1	Fibroblasts
CAAGACTAGATGAATC-1	Fibroblasts
CAAGACTAGCATATGA-1	Epithelial cells
CAAGACTAGGCGACAT-1	Epithelial cells
CAAGACTCACTTCTCG-1	Monocytes
CAAGACTCATTGAGCT-1	T cells
CAAGACTGTTCCGTTC-1	T cells
CAAGACTTCAACTGAC-1	Fibroblasts
CAAGAGGAGCGACAGT-1	Monocytes
CAAGAGGCAACGGTAG-1	Macrophages
CAAGAGGGTAGCTTTG-1	Fibroblasts
CAAGAGGGTAGTCACT-1	pDC
CAAGAGGTCACCCTTG-1	Endothelial cells
CAAGCTACAACTGCCG-1	Fibroblasts
CAAGCTACATGTTCGA-1	Fibroblasts
CAAGCTAGTAAGCAAT-1	T cells
CAAGCTAGTGTACGCC-1	Macrophages
CAAGCTAGTTCGGACC-1	Fibroblasts
CAAGCTAGTTGGTGTT-1	T cells
CAAGCTATCATCGTAG-1	Fibroblasts
CAAGCTATCGCAGAGA-1	T cells
CAAGCTATCTACTTCA-1	T cells
CAAGGGACACATACGT-1	Fibroblasts
CAAGGGATCGTGGGAA-1	NK cells
CAAGGGATCTAGTGTG-1	Fibroblasts
CAATACGGTCACCTTC-1	Fibroblasts
CAATACGGTTCATCTT-1	Monocytes
CAATACGTCAAAGGTA-1	T cells
CAATACGTCACGGAGA-1	T cells
CAATACGTCACGGGAA-1	T cells
CAATACGTCTGCTTTA-1	T cells
CAATCGAAGCCATATC-1	Epithelial cells
CAATCGAAGGCCTGAA-1	Fibroblasts
CAATCGACACACCGCA-1	Fibroblasts
CAATCGACACGGTGTC-1	Epithelial cells
CAATCGAGTACCGTGC-1	Fibroblasts
CAATCGAGTCATAAAG-1	Endothelial cells
CAATCGAGTCTACAGT-1	Epithelial cells
CAATCGATCATCGCTC-1	Fibroblasts
CAATGACAGTTGTAGA-1	pDC
CAATGACCACGTAGTT-1	T cells
CAATGACCATCGTCCT-1	Epithelial cells
CAATGACGTGATCATC-1	Epithelial cells
CAATGACGTTACGGAG-1	T cells
CAATGACGTTATGTCG-1	B cells
CAATGACTCCATTCAT-1	NK cells
CAATGACTCCTTATGT-1	Fibroblasts
CAATGACTCGGTCATA-1	Monocytes
CAATGACTCTCATGGA-1	T cells
CAATGACTCTCCCAAC-1	T cells
CAATTTCAGATGCCGA-1	Fibroblasts
CAATTTCAGTATCCTG-1	T cells
CAATTTCCAATGTTGC-1	T cells
CAATTTCGTGTTCCAA-1	Macrophages
CAATTTCTCGTCAGAT-1	Fibroblasts
CAATTTCTCTTCGACC-1	DC
CACAACAAGGTTTACC-1	Endothelial cells
CACAACACAAATCAGA-1	Fibroblasts
CACAACAGTATCCTTT-1	T cells
CACAACAGTCGTACTA-1	Fibroblasts
CACAACAGTCTAGTGT-1	Fibroblasts
CACAACATCAAGAGTA-1	Endothelial cells
CACAACATCACTCCGT-1	NK cells
CACAACATCCTACCAC-1	Epithelial cells
CACAACATCGAGTCCG-1	Fibroblasts
CACACAAAGCGCCCAT-1	DC
CACACAAAGTCATCCA-1	T cells
CACACAACAAAGTATG-1	T cells
CACACAACAAGCGCTC-1	Monocytes
CACACAACAGCGAGTA-1	Fibroblasts
CACACAAGTCATTCCC-1	B cells
CACACAAGTTGTTGCA-1	Fibroblasts
CACACAATCGCAGTGC-1	Monocytes
CACACAATCGCATTGA-1	Fibroblasts
CACACAATCTTCGACC-1	Monocytes
CACAGATAGCACTTTG-1	B cells
CACAGATAGCCGTAAG-1	Macrophages
CACAGATCAAGAGATT-1	T cells
CACAGATCATCGATAC-1	Fibroblasts
CACAGATGTGCAATGG-1	NK cells
CACAGATGTTTGAAAG-1	Epithelial cells
CACAGATTCACTACGA-1	T cells
CACAGATTCTGTCCGT-1	T cells
CACAGATTCTGTTGGA-1	Fibroblasts
CACAGGCAGCGACTTT-1	NK cells
CACAGGCAGCTATCTG-1	T cells
CACAGGCAGCTCCATA-1	Fibroblasts
CACAGGCAGGTAGCAC-1	Endothelial cells
CACAGGCCAAAGGCGT-1	Fibroblasts
CACAGGCCACCTTCCA-1	Fibroblasts
CACAGGCTCAGCTTCC-1	Fibroblasts
CACAGGCTCATCGCCT-1	Epithelial cells
CACATGAAGACCAACG-1	B cells
CACATGAAGGAGAGGC-1	Fibroblasts
CACATGACACTTGGGC-1	Epithelial cells
CACATGATCATCCTAT-1	Epithelial cells
CACATGATCCACGGAC-1	Fibroblasts
CACATGATCGAAACAA-1	T cells
CACCAAAAGGCACTAG-1	Fibroblasts
CACCAAACACCAAATC-1	Fibroblasts
CACCAAACAGCAATTC-1	Fibroblasts
CACCAAAGTACCCGCA-1	Epithelial cells
CACCAAAGTCGCATCG-1	Epithelial cells
CACCAAAGTGATCGTT-1	Fibroblasts
CACCAAATCCCTTGTG-1	Fibroblasts
CACCAAATCCGCCTAT-1	T cells
CACCAAATCGTGCATA-1	T cells
CACCGTTAGAGGTTAT-1	B cells
CACCGTTAGGGTTGCA-1	Epithelial cells
CACCGTTGTCTCGACG-1	T cells
CACCGTTTCAGATGCT-1	T cells
CACCGTTTCGTGAGAG-1	DC
CACGAATAGCACTCTA-1	T cells
CACGAATAGGTATAGT-1	B cells
CACGAATCAGCGACAA-1	Fibroblasts
CACGAATGTACCGGAA-1	T cells
CACGGGTAGGGAGGCA-1	Fibroblasts
CACGGGTAGGTGATAT-1	Monocytes
CACGGGTCAATAAGGT-1	T cells
CACGGGTTCTGCGGAC-1	T cells
CACGTGGAGACATACA-1	Fibroblasts
CACGTGGCAAGTGGCA-1	Epithelial cells
CACGTGGGTACTCAAC-1	Epithelial cells
CACGTGGGTGGTCTTA-1	T cells
CACGTGGGTTAAAGTG-1	Fibroblasts
CACGTTCGTCCACGCA-1	Monocytes
CACGTTCGTTTCGTGA-1	Endothelial cells
CACGTTCTCAGCGCGT-1	Fibroblasts
CACGTTCTCCTCACGT-1	Fibroblasts
CACGTTCTCTCGGCTT-1	T cells
CACTAAGCAGCTAACT-1	Epithelial cells
CACTAAGGTCAAAGTA-1	T cells
CACTAAGGTCATCAGT-1	Epithelial cells
CACTAAGGTGGATGAC-1	Epithelial cells
CACTAAGGTTATCCAG-1	Monocytes
CACTAAGTCCGAAATC-1	T cells
CACTAAGTCGGTCTAA-1	Fibroblasts
CACTAAGTCTCCAAGA-1	Endothelial cells
CACTGAAAGGTAAGAG-1	NK cells
CACTGAAAGTGTACAA-1	Endothelial cells
CACTGAACAACAGTGG-1	T cells
CACTGAACAAGTGGAC-1	Fibroblasts
CACTGAAGTGGTACAG-1	pDC
CACTGAAGTTGTGGCC-1	Endothelial cells
CACTGAATCCTCCACA-1	Epithelial cells
CACTGGGCACCCAATA-1	Fibroblasts
CACTGGGGTCACCTTC-1	Macrophages
CACTGGGGTGGATTTC-1	Fibroblasts
CACTGGGGTGTAAACA-1	T cells
CACTGGGGTTAACAGA-1	Monocytes
CACTGGGGTTATCTTC-1	T cells
CACTGGGGTTTGAACC-1	Fibroblasts
CACTGGGTCACCATCC-1	T cells
CACTGTCCAATTAGGA-1	DC
CACTGTCCACGGTCTG-1	Epithelial cells
CACTGTCGTCCTCCTA-1	NK cells
CACTGTCTCATGCCCT-1	Fibroblasts
CACTTCGAGGGCATGT-1	T cells
CACTTCGCACGTAGAG-1	Macrophages
CACTTCGCACTTCATT-1	B cells
CACTTCGCATCTCAAG-1	Fibroblasts
CACTTCGGTTCTAACG-1	Fibroblasts
CAGAGCCAGACCATGG-1	T cells
CAGAGCCCAAACTGCT-1	T cells
CAGAGCCCACACTGGC-1	Fibroblasts
CAGAGCCCATCGAGCC-1	Epithelial cells
CAGAGCCGTCATAAAG-1	Epithelial cells
CAGAGCCGTTGGACCC-1	T cells
CAGAGCCTCCCGAACG-1	Epithelial cells
CAGATACAGCGATCGA-1	T cells
CAGATACAGTTGTCGT-1	Plasma cells
CAGATACGTGTCCACG-1	Epithelial cells
CAGATACTCCCAGGCA-1	T cells
CAGATCAAGACTCAAA-1	T cells
CAGATCAAGATGGCGT-1	T cells
CAGATCAAGCGTGTCC-1	B cells
CAGATCAAGGAATCGC-1	Fibroblasts
CAGATCAAGGGACTGT-1	T cells
CAGATCACAAAGGCGT-1	Epithelial cells
CAGATCACATCATTGG-1	Fibroblasts
CAGATCACATTCGATG-1	pDC
CAGATCAGTACGCGTC-1	Epithelial cells
CAGATCAGTCACCCTT-1	Epithelial cells
CAGATCAGTTGCAACT-1	Fibroblasts
CAGATCAGTTTGCCGG-1	Macrophages
CAGATCATCGGCACTG-1	T cells
CAGATCATCTGCGGAC-1	Fibroblasts
CAGATTGAGAGAAGGT-1	pDC
CAGATTGAGCGCTGAA-1	T cells
CAGATTGAGGTTCCAT-1	Fibroblasts
CAGATTGAGTGCTCAT-1	Fibroblasts
CAGATTGCATGCTGCG-1	T cells
CAGATTGTCGAGCACC-1	Fibroblasts
CAGCAATAGATAACAC-1	T cells
CAGCAATCAGTGGCTC-1	Macrophages
CAGCAATCATATTCGG-1	T cells
CAGCAATGTAAGATAC-1	Monocytes
CAGCAATGTTGTGTTG-1	Monocytes
CAGCAATGTTGTTGCA-1	T cells
CAGCAATTCAGAGCAG-1	Fibroblasts
CAGCAATTCAGCTTCC-1	Fibroblasts
CAGCAATTCCAAGCAT-1	DC
CAGCAATTCCAGTGTA-1	T cells
CAGCACGCAGGTCTCG-1	B cells
CAGCACGGTCACTGAT-1	T cells
CAGCACGGTTCGGCCA-1	T cells
CAGCACGTCCACGTCT-1	DC
CAGCACGTCCACGTGG-1	T cells
CAGCAGCCAAGAATAC-1	Fibroblasts
CAGCAGCCACGCGCAT-1	T cells
CAGCAGCGTAAGGTCG-1	Epithelial cells
CAGCAGCGTCATACCA-1	Fibroblasts
CAGCAGCGTGGCACTC-1	Epithelial cells
CAGCAGCTCCGTGTGG-1	Monocytes
CAGCAGCTCCGTTTCG-1	Fibroblasts
CAGCAGCTCTCCTGCA-1	Fibroblasts
CAGCCAGAGCAGGGAG-1	Epithelial cells
CAGCCAGAGCCGATAG-1	T cells
CAGCCAGAGCGGTAGT-1	Epithelial cells
CAGCCAGAGGACGCTA-1	Fibroblasts
CAGCCAGCAGACTGCC-1	Fibroblasts
CAGCCAGGTCCATAGT-1	Monocytes
CAGCCAGGTGCACATT-1	Fibroblasts
CAGCCAGTCCGGCTTT-1	T cells
CAGCGTGCATCTTCGC-1	T cells
CAGCGTGGTCACAGAG-1	B cells
CAGCGTGGTTCTAACG-1	T cells
CAGCGTGTCTGTTGGA-1	NK cells
CAGCGTGTCTTAGGAC-1	B cells
CAGGCCAAGTAATCCC-1	Fibroblasts
CAGGCCAGTCGTGTTA-1	Epithelial cells
CAGGCCATCGACTCCT-1	T cells
CAGGGCTAGACGCATG-1	T cells
CAGGGCTAGGTAAGGA-1	Fibroblasts
CAGGGCTAGGTGCTAG-1	Monocytes
CAGGGCTAGTCTGGTT-1	Macrophages
CAGGGCTCAATCGAAA-1	T cells
CAGGGCTTCCTTCACG-1	T cells
CAGGTATAGGTGGCTA-1	Monocytes
CAGGTATCACGAGGTA-1	T cells
CAGGTATCAGAGGCAT-1	T cells
CAGGTATCATGCTGCG-1	T cells
CAGGTATGTGCATTTG-1	T cells
CAGTGCGAGCAGGTCA-1	Monocytes
CAGTGCGAGGGCAGAG-1	Endothelial cells
CAGTGCGCACAAACGG-1	Endothelial cells
CAGTGCGCAGGATCTT-1	T cells
CAGTGCGCATGCACTA-1	T cells
CAGTGCGGTACAACGG-1	T cells
CAGTGCGGTGGGTCAA-1	T cells
CAGTTAGAGACCTGGA-1	T cells
CAGTTAGTCTTCCGTG-1	Fibroblasts
CAGTTCCAGACCAGCA-1	T cells
CAGTTCCCAACGTAAA-1	Epithelial cells
CAGTTCCCAAGTTCGT-1	Fibroblasts
CAGTTCCCATTGCAAC-1	Epithelial cells
CAGTTCCGTACAACGG-1	Fibroblasts
CAGTTCCGTCGTTTCC-1	T cells
CAGTTCCGTGACTAAA-1	T cells
CAGTTCCGTTGCTCCT-1	Monocytes
CAGTTCCGTTGGGTTT-1	T cells
CAGTTCCTCACTGATG-1	Fibroblasts
CATAAGCCAAGCAATA-1	Fibroblasts
CATAAGCCACAGTGAG-1	Fibroblasts
CATAAGCGTCTACTGA-1	Fibroblasts
CATAAGCTCACACGAT-1	Fibroblasts
CATAAGCTCGCTGACG-1	Fibroblasts
CATACAGAGCGATTCT-1	B cells
CATACAGAGTTTCAGC-1	Epithelial cells
CATACAGCAGAGCCCT-1	Monocytes
CATACAGGTAACATGA-1	Fibroblasts
CATACAGTCAGCTAGT-1	Epithelial cells
CATACCCAGCTTCATG-1	T cells
CATACCCAGGAATTAC-1	Fibroblasts
CATACCCCAGGATCTT-1	Epithelial cells
CATACCCTCAACCTTT-1	Fibroblasts
CATACCCTCAACGCTA-1	Epithelial cells
CATACCCTCGGAATTC-1	Epithelial cells
CATACTTAGATTAGAC-1	T cells
CATACTTAGCTTTGTG-1	Epithelial cells
CATACTTCAACTGGTT-1	DC
CATACTTCACAAGTTC-1	Fibroblasts
CATACTTCAGGCTTGC-1	Epithelial cells
CATACTTGTCCTGGGT-1	Monocytes
CATACTTGTCGTTATG-1	T cells
CATACTTGTGGCAACA-1	Fibroblasts
CATACTTTCGTTCGCT-1	Monocytes
CATAGACCATTGACAC-1	Fibroblasts
CATAGACGTAGCTGTT-1	Fibroblasts
CATAGACTCGGTGTAT-1	Endothelial cells
CATCAAGAGGCGTTAG-1	Fibroblasts
CATCAAGAGTCGAATA-1	T cells
CATCAAGGTCGTTATG-1	T cells
CATCAAGGTCTCCTGT-1	Macrophages
CATCAAGTCATAGGCT-1	T cells
CATCAAGTCGGTCGAC-1	T cells
CATCAAGTCTAGAGCT-1	T cells
CATCCACCATATCTCT-1	Epithelial cells
CATCCACGTACGGGAT-1	T cells
CATCCACTCACCTCGT-1	Epithelial cells
CATCCACTCGCTAGCG-1	Fibroblasts
CATCCCAAGAAATTGC-1	Endothelial cells
CATCCCAAGCACTCGC-1	Epithelial cells
CATCCCAAGGACGCAT-1	Fibroblasts
CATCCCAAGGCACTCC-1	Fibroblasts
CATCCCAAGTAGTCTC-1	Monocytes
CATCCCACAGGACTAG-1	Epithelial cells
CATCCCACAGGTCTCG-1	T cells
CATCCCAGTTCAATCG-1	T cells
CATCCCAGTTCCACGG-1	T cells
CATCCCATCCACCTGT-1	Epithelial cells
CATCCCATCTTGGCTC-1	NK cells
CATCCGTAGAGGCGTT-1	Monocytes
CATCCGTAGCAATTAG-1	T cells
CATCCGTCAATGGCCC-1	T cells
CATCCGTGTCGGTGTC-1	Fibroblasts
CATCCGTTCTTACCAT-1	Endothelial cells
CATCGCTAGTCACTGT-1	Epithelial cells
CATCGCTCAACAGCTT-1	Fibroblasts
CATCGCTCAGAAGTTA-1	Endothelial cells
CATCGCTTCCCGAACG-1	Epithelial cells
CATCGCTTCCCTCTCC-1	Fibroblasts
CATCGCTTCGACGACC-1	T cells
CATCGCTTCTACACTT-1	Fibroblasts
CATCGGGCAATACCCA-1	Fibroblasts
CATCGGGGTAACCAGG-1	T cells
CATCGGGTCATTTGGG-1	T cells
CATCGGGTCCATTTGT-1	Fibroblasts
CATCGGGTCCGTAATG-1	Epithelial cells
CATCGGGTCGCGGACT-1	Fibroblasts
CATCGGGTCGCTCCTA-1	Epithelial cells
CATCGTCAGCGCCTTG-1	T cells
CATCGTCAGTAGAGTT-1	T cells
CATCGTCAGTATGCAA-1	T cells
CATCGTCCACCCTAGG-1	Epithelial cells
CATCGTCCAGATCATC-1	Endothelial cells
CATCGTCTCCATTTGT-1	Monocytes
CATGAGTAGCACCGAA-1	Fibroblasts
CATGAGTAGGTAAGTT-1	T cells
CATGAGTCAAACGGCA-1	Fibroblasts
CATGAGTCAGAACGCA-1	Fibroblasts
CATGAGTGTGAGGATC-1	Epithelial cells
CATGAGTTCACCGGTG-1	Endothelial cells
CATGAGTTCCTCTAAT-1	Fibroblasts
CATGCAACAGTCCCGA-1	Endothelial cells
CATGCAACAGTGACCC-1	Mast cells
CATGCAAGTAGATTGA-1	Monocytes
CATGCAAGTGTGGTCC-1	Epithelial cells
CATGCCTAGGTGCAGT-1	T cells
CATGCCTCACGACGTC-1	Monocytes
CATGCCTGTCGCACAC-1	T cells
CATGCCTTCATGCAGT-1	B cells
CATGCCTTCATGGCCG-1	T cells
CATGCCTTCGAGTACT-1	T cells
CATGCGGCATTCAGGT-1	Epithelial cells
CATGCGGGTTCTGAGT-1	Fibroblasts
CATGCGGGTTTGTTGG-1	Epithelial cells
CATGCGGTCCGTAATG-1	NK cells
CATGCGGTCTGGTGCG-1	T cells
CATGCTCAGTTGGAGC-1	Fibroblasts
CATGCTCGTAGCTGCC-1	Monocytes
CATGCTCGTCAAGTTC-1	T cells
CATGCTCGTCGCCACA-1	Fibroblasts
CATGCTCGTTATCTGG-1	T cells
CATGCTCTCTTGATTC-1	T cells
CATGGATCACGGCGTT-1	Fibroblasts
CATGGATGTCTACACA-1	T cells
CATGGATGTTAAGTCC-1	Fibroblasts
CATGGATGTTGGGAAC-1	Monocytes
CATGGATGTTGTACGT-1	T cells
CATGGATTCCGGTAAT-1	Macrophages
CATGGTAGTGGCCTCA-1	T cells
CATGGTAGTTTCGTTT-1	Fibroblasts
CATGGTATCACCTCAC-1	pDC
CATGGTATCATGACAC-1	T cells
CATGGTATCTGCGTCT-1	T cells
CATGGTATCTTAGGAC-1	T cells
CATTCATAGCAGGTCA-1	T cells
CATTCATCAACGTAAA-1	T cells
CATTCATCACCGCTAG-1	Endothelial cells
CATTCATTCAAGCCGC-1	Fibroblasts
CATTCATTCCGATCTC-1	T cells
CATTCATTCCGGCAGT-1	NK cells
CATTCATTCTTGTGCC-1	T cells
CATTCCGAGCACACCC-1	T cells
CATTCCGAGCCGATCC-1	Monocytes
CATTCCGCAACAGTGG-1	Plasma cells
CATTCCGGTGACTATC-1	Epithelial cells
CATTCCGGTGTATCCA-1	Macrophages
CATTCCGTCTGAGATC-1	Fibroblasts
CATTCTAAGTAACAGT-1	Epithelial cells
CATTCTACATGCACTA-1	Macrophages
CATTCTAGTCGCAACC-1	T cells
CATTCTAGTCGCCTAG-1	T cells
CATTCTATCACCGGGT-1	Fibroblasts
CATTCTATCCAGCCTT-1	Fibroblasts
CATTGAGCACACCGAC-1	Epithelial cells
CATTGAGGTACGGGAT-1	Monocytes
CATTGAGGTAGCTGTT-1	Fibroblasts
CATTGAGGTCGGATTT-1	Fibroblasts
CATTGAGGTTCATCTT-1	B cells
CATTGAGGTTCCAGGC-1	pDC
CATTGAGTCATAGAGA-1	Epithelial cells
CATTGAGTCCACCTGT-1	Fibroblasts
CATTGAGTCGCCTCTA-1	Fibroblasts
CATTGCCAGACGCCCT-1	T cells
CATTGCCAGGTAGACC-1	Monocytes
CATTGCCAGGTCGTCC-1	Fibroblasts
CATTGCCAGTGTCATC-1	Fibroblasts
CATTGCCCACAACCGC-1	Epithelial cells
CATTGCCGTACTAGCT-1	Fibroblasts
CATTGCCGTATCCTCC-1	Fibroblasts
CATTGCCGTGTACGCC-1	T cells
CATTGCCTCACCCTCA-1	Epithelial cells
CATTGCCTCGTCAACA-1	Fibroblasts
CATTGCCTCGTCAGAT-1	Epithelial cells
CATTGCCTCTAGCCAA-1	Fibroblasts
CATTGCCTCTTCACAT-1	Epithelial cells
CATTGCCTCTTCGCTG-1	T cells
CATTGTTAGTAAGGGA-1	T cells
CATTGTTCAATAGTGA-1	T cells
CATTGTTCAGAAGTTA-1	Monocytes
CATTGTTGTGGTATGG-1	Epithelial cells
CATTGTTTCAAAGGAT-1	Fibroblasts
CATTGTTTCGGTCTGG-1	Monocytes
CATTTCAAGCTTCGTA-1	T cells
CATTTCACAAATCCCA-1	Epithelial cells
CATTTCACAGAACTCT-1	Fibroblasts
CATTTCACAGCGTGCT-1	T cells
CATTTCAGTGTATTGC-1	Epithelial cells
CATTTCAGTTCTCACC-1	DC
CCAAGCGAGATGCTAA-1	T cells
CCAAGCGAGATTAGTG-1	T cells
CCAAGCGAGGACGCTA-1	Fibroblasts
CCAAGCGGTGGATTTC-1	T cells
CCAATGAAGACTTCCA-1	Endothelial cells
CCAATGAAGCTACAAA-1	Mast cells
CCAATGACACAAGTGG-1	T cells
CCAATGAGTAGCGTTT-1	T cells
CCAATGAGTCACAGAG-1	Epithelial cells
CCAATTTAGCGCCCAT-1	T cells
CCAATTTAGGACGGAG-1	Fibroblasts
CCAATTTCAACGATTC-1	T cells
CCAATTTCACGCTTAA-1	Fibroblasts
CCAATTTCACTTCATT-1	Monocytes
CCAATTTCAGCTATTG-1	Endothelial cells
CCAATTTGTATTTCCT-1	Macrophages
CCAATTTGTCTGGTTA-1	Epithelial cells
CCAATTTGTTCAGCGC-1	T cells
CCACAAACAAGAAATC-1	T cells
CCACAAACAATTGCCA-1	Epithelial cells
CCACAAAGTGGTAACG-1	Fibroblasts
CCACAAATCAGAGTTC-1	Endothelial cells
CCACAAATCCGTATAG-1	DC
CCACAAATCCTTGAAG-1	Epithelial cells
CCACAAATCGACGAGA-1	T cells
CCACAAATCTATTTCG-1	NK cells
CCACACTCACCTGATA-1	NK cells
CCACACTCATTGACTG-1	T cells
CCACACTGTTTGGGTT-1	Monocytes
CCACACTTCAAAGAAC-1	Fibroblasts
CCACACTTCGGACGTC-1	DC
CCACACTTCTGAGTCA-1	Monocytes
CCACCATAGAGAGGGC-1	Epithelial cells
CCACCATAGATTCGCT-1	Macrophages
CCACCATAGCCTCCAG-1	Epithelial cells
CCACCATGTCTTACAG-1	T cells
CCACCATGTTCATCTT-1	T cells
CCACCATTCAGGACAG-1	Fibroblasts
CCACCATTCGTGTTCC-1	T cells
CCACCATTCTATCCAT-1	Epithelial cells
CCACGAGAGAACGTGC-1	T cells
CCACGAGAGGTCCAGA-1	T cells
CCACGAGCAAAGACGC-1	B cells
CCACGAGCAAATAGCA-1	T cells
CCACGAGCATGAAGCG-1	NK cells
CCACGAGTCAAGCTGT-1	Macrophages
CCACGAGTCCGCAGTG-1	Fibroblasts
CCACGTTAGCACGGAT-1	Epithelial cells
CCACGTTAGGCATCTT-1	Monocytes
CCACGTTCAAGGGCAT-1	pDC
CCACGTTCACATTCGA-1	Fibroblasts
CCACGTTGTAAGAACT-1	Fibroblasts
CCACGTTGTCTTGAGT-1	Fibroblasts
CCACGTTGTTGGGAAC-1	T cells
CCACGTTTCAAAGGAT-1	Macrophages
CCACGTTTCGTCGACG-1	NK cells
CCACGTTTCTAGCATG-1	Fibroblasts
CCACTTGAGGTCGTGA-1	Mast cells
CCACTTGAGTAAAGCT-1	Fibroblasts
CCACTTGAGTCATAGA-1	Epithelial cells
CCACTTGCATATGGCT-1	ILC
CCACTTGGTCGGTACC-1	Fibroblasts
CCACTTGGTGCCTTTC-1	Fibroblasts
CCACTTGTCAATCTCT-1	Fibroblasts
CCACTTGTCAGCCTCT-1	T cells
CCACTTGTCATCTATC-1	Fibroblasts
CCACTTGTCATTGTGG-1	DC
CCACTTGTCCATAGGT-1	Plasma cells
CCACTTGTCGGTCGAC-1	Fibroblasts
CCATAAGAGCTATCCA-1	Fibroblasts
CCATAAGAGGATACGC-1	Fibroblasts
CCATAAGCATGCTGCG-1	T cells
CCATAAGGTAGGTTTC-1	T cells
CCATAAGGTGTCATCA-1	Monocytes
CCATAAGGTTCAGCGC-1	T cells
CCATAAGTCGAACCTA-1	Fibroblasts
CCATAAGTCGATTGAC-1	T cells
CCATAAGTCTCGTCAC-1	T cells
CCATCACAGGGTGGGA-1	T cells
CCATCACCATCCCGTT-1	Epithelial cells
CCATCACGTATATGGA-1	Fibroblasts
CCATCACGTCAAGCCC-1	T cells
CCATCACGTGTTCCAA-1	T cells
CCATCACTCAACCTCC-1	T cells
CCATCACTCAAGTTGC-1	T cells
CCATCACTCTGAGAGG-1	B cells
CCATCACTCTTCCAGC-1	Fibroblasts
CCCAACTAGACCACGA-1	Monocytes
CCCAACTAGGAACGCT-1	T cells
CCCAACTAGTTTGCTG-1	Fibroblasts
CCCAACTCACGTGTGC-1	Epithelial cells
CCCAACTGTCTGATAC-1	B cells
CCCAACTTCCTACAAG-1	Macrophages
CCCATTGGTATTGACC-1	T cells
CCCATTGGTGCGAACA-1	Fibroblasts
CCCATTGGTTGTGCCG-1	T cells
CCCATTGTCTGTTGGA-1	T cells
CCCGAAGGTCTAATCG-1	Monocytes
CCCGAAGGTTCAGCTA-1	Epithelial cells
CCCGAAGGTTGCCATA-1	B cells
CCCGAAGTCCAGCCTT-1	T cells
CCCGGAAAGCCTCGTG-1	T cells
CCCGGAAAGGGATGTC-1	T cells
CCCGGAACACCCAAGC-1	ILC
CCCGGAACACCCTCTA-1	Fibroblasts
CCCGGAAGTGACTAAA-1	T cells
CCCGGAAGTGCGGTAA-1	Epithelial cells
CCCGGAATCTAATTCC-1	DC
CCCGGAATCTCTATAC-1	Epithelial cells
CCCTAACAGGATGCGT-1	T cells
CCCTAACCAGCTTCCT-1	Monocytes
CCCTAACTCACATACG-1	Epithelial cells
CCCTAACTCACGACTA-1	Fibroblasts
CCCTAACTCAGGACGA-1	T cells
CCCTCAAAGGTGCTTT-1	Epithelial cells
CCCTCAAGTGGATCGA-1	Fibroblasts
CCCTCAATCGTCGATA-1	T cells
CCCTCAATCTGTTCAT-1	Macrophages
CCCTCTCAGCAAGTCG-1	B cells
CCCTCTCCAAGAGTTA-1	T cells
CCCTCTCCACTAGGTT-1	T cells
CCCTCTCGTGACCGAA-1	Monocytes
CCCTCTCTCAAGGTGG-1	Fibroblasts
CCCTCTCTCAGCTTGA-1	Epithelial cells
CCCTCTCTCCGTGTGG-1	T cells
CCCTCTCTCGTCCTTG-1	T cells
CCCTGATAGATACTGA-1	Fibroblasts
CCCTGATAGCCTCTGG-1	Fibroblasts
CCCTTAGAGCCGAATG-1	T cells
CCCTTAGCAATAAGGT-1	ILC
CCCTTAGGTCGTCGGT-1	Macrophages
CCCTTAGTCAAAGGTA-1	Epithelial cells
CCCTTAGTCCAAGCCG-1	T cells
CCCTTAGTCCATTCGC-1	Epithelial cells
CCCTTAGTCGAGCCTG-1	T cells
CCGAACGAGACCTGGA-1	T cells
CCGAACGCACATTCTT-1	Monocytes
CCGAACGGTCGGTGTC-1	Epithelial cells
CCGAACGGTTCTCCTG-1	T cells
CCGAACGTCAACTGAC-1	Epithelial cells
CCGATCTAGCATAGGC-1	Epithelial cells
CCGATCTAGCGCCATC-1	Fibroblasts
CCGATCTAGGGCAGGA-1	Fibroblasts
CCGATCTGTACGCGTC-1	T cells
CCGATCTGTATGCTAC-1	NK cells
CCGATCTGTATTCCGA-1	T cells
CCGATCTTCTTCGACC-1	Fibroblasts
CCGATGGAGCAAATGT-1	T cells
CCGATGGCAGCTCATA-1	T cells
CCGATGGGTAGATTAG-1	Monocytes
CCGCAAGAGGAAGTCC-1	Epithelial cells
CCGCAAGAGTTACGAA-1	Fibroblasts
CCGCAAGCAACATCGT-1	Fibroblasts
CCGCAAGTCCACAGCG-1	Epithelial cells
CCGGACAAGACGCCCT-1	T cells
CCGGACAAGTGCAAAT-1	Fibroblasts
CCGGACACAACGATTC-1	Fibroblasts
CCGGACACAATGCTCA-1	NK cells
CCGGACACAGCTTTGA-1	Fibroblasts
CCGGACACAGGAGGAG-1	Fibroblasts
CCGGACAGTGCCGTAC-1	Endothelial cells
CCGGACAGTGCGCTCA-1	Fibroblasts
CCGGGTAAGCACTAGG-1	T cells
CCGGGTAAGTAGGAAG-1	Fibroblasts
CCGGGTACACCTCAGG-1	Monocytes
CCGGGTAGTCGGCCTA-1	Fibroblasts
CCGGGTATCTTACGTT-1	Fibroblasts
CCGGTAGAGGTCCCTG-1	T cells
CCGGTAGGTTCGTACA-1	Fibroblasts
CCGGTAGTCCCGTGAG-1	Fibroblasts
CCGGTGAAGCCGTAAG-1	Fibroblasts
CCGGTGAGTGGCCCAT-1	T cells
CCGGTGAGTTCGTTCC-1	Fibroblasts
CCGGTGATCTGCGGAC-1	Fibroblasts
CCGTAGGCAACTGCCG-1	Fibroblasts
CCGTAGGCAGACATCT-1	T cells
CCGTAGGCATCCTTGC-1	Macrophages
CCGTAGGTCTTCGTAT-1	Epithelial cells
CCGTGAGAGTAACCTC-1	B cells
CCGTGAGCACTAGGCC-1	T cells
CCGTGAGGTATGAAGT-1	Epithelial cells
CCGTGAGGTATGTCTG-1	T cells
CCGTGAGTCGTTAGAC-1	NK cells
CCGTTCAAGCGAGAAA-1	Plasma cells
CCGTTCAAGCGTGTTT-1	T cells
CCGTTCAAGTCGAAGC-1	T cells
CCGTTCACACGGTGCT-1	Monocytes
CCGTTCAGTACTCCGG-1	Epithelial cells
CCGTTCAGTGTCTTGA-1	Fibroblasts
CCGTTCATCCCATACC-1	Fibroblasts
CCGTTCATCCCATTCG-1	B cells
CCTAACCAGACTCTTG-1	Epithelial cells
CCTAACCAGCGGCTCT-1	Epithelial cells
CCTAACCCAACGTATC-1	Fibroblasts
CCTAACCTCCACTTCG-1	T cells
CCTAACCTCCCAATAG-1	Endothelial cells
CCTAACCTCCGACAGC-1	Fibroblasts
CCTAACCTCGTCTACC-1	T cells
CCTAACCTCTCACCCA-1	T cells
CCTAAGAAGAGTCAAT-1	Epithelial cells
CCTAAGAAGCGCTGCT-1	T cells
CCTAAGAAGGTGATAT-1	T cells
CCTAAGACAACGGTAG-1	pDC
CCTAAGAGTAAGATTG-1	T cells
CCTAAGAGTCTGTGAT-1	T cells
CCTAAGAGTTTCAGAC-1	Epithelial cells
CCTAAGATCACTGGTA-1	Epithelial cells
CCTAAGATCAGGTGTT-1	Fibroblasts
CCTACGTAGATAGTCA-1	Plasma cells
CCTACGTCAACCGATT-1	Endothelial cells
CCTACGTCAACGGCTC-1	Endothelial cells
CCTACGTCATTGGGAG-1	Fibroblasts
CCTACGTGTTATCTGG-1	Epithelial cells
CCTACGTTCATTACCT-1	Epithelial cells
CCTACGTTCATTATCC-1	Endothelial cells
CCTATCGAGTGCTACT-1	T cells
CCTATCGGTATCACCA-1	Epithelial cells
CCTATCGGTGACCGTC-1	DC
CCTCAACCACCGTCGA-1	T cells
CCTCAACTCAGCCTTC-1	Macrophages
CCTCAACTCGCGATCG-1	B cells
CCTCAACTCTGAGCAT-1	Epithelial cells
CCTCACAAGACGAAGA-1	Fibroblasts
CCTCACAAGATAACAC-1	T cells
CCTCACAAGCCAGTAG-1	Fibroblasts
CCTCACAAGGGTACGT-1	T cells
CCTCACACAAGCGCAA-1	NK cells
CCTCACAGTATTCCGA-1	Monocytes
CCTCACAGTCACTTCC-1	Macrophages
CCTCACAGTGACTATC-1	Fibroblasts
CCTCACAGTGCGTTTA-1	T cells
CCTCACATCTTCCAGC-1	Fibroblasts
CCTCAGTAGACTCATC-1	T cells
CCTCAGTAGAGTTGCG-1	Epithelial cells
CCTCAGTCAGTGCCTG-1	T cells
CCTCAGTGTAGCGTCC-1	T cells
CCTCAGTTCACGACTA-1	Epithelial cells
CCTCAGTTCCAACTGA-1	Fibroblasts
CCTCAGTTCCTTCTGG-1	Epithelial cells
CCTCAGTTCTACTATC-1	Fibroblasts
CCTCATGAGTCATACC-1	Monocytes
CCTCATGGTAAGTTGA-1	B cells
CCTCATGGTTTGTGGT-1	T cells
CCTCATGTCTCGTGAA-1	T cells
CCTCCAAAGAAGAACG-1	Fibroblasts
CCTCCAAAGTGAGTGC-1	Epithelial cells
CCTCCAACACTACCCT-1	Fibroblasts
CCTCCAAGTACCCGAC-1	Endothelial cells
CCTCCAATCCGAGCTG-1	Fibroblasts
CCTCCAATCTTCGGTC-1	Epithelial cells
CCTCCTCAGTGGTCAG-1	Fibroblasts
CCTCCTCAGTTGCGAG-1	Fibroblasts
CCTCTAGCAACCGCCA-1	Fibroblasts
CCTCTAGCAAGCACAG-1	T cells
CCTCTAGCACCGCTAG-1	Fibroblasts
CCTCTAGCACTAGGCC-1	T cells
CCTCTAGGTTCTTAGG-1	T cells
CCTCTAGGTTGCTGAT-1	Fibroblasts
CCTCTAGTCGTGTGAT-1	T cells
CCTCTCCCAGAGGAAA-1	T cells
CCTCTCCCATGCAGGA-1	T cells
CCTCTCCGTTGTTGAC-1	Monocytes
CCTCTCCTCACCGACG-1	Fibroblasts
CCTCTCCTCACGGGCT-1	T cells
CCTGCATAGATTGAGT-1	Epithelial cells
CCTGCATAGCCTGGAA-1	DC
CCTGCATCACCATTCC-1	Epithelial cells
CCTGCATCAGGGAATC-1	Fibroblasts
CCTGCATGTACTGCGC-1	T cells
CCTGCATGTCCAAGAG-1	T cells
CCTGCATGTTCAATCG-1	Fibroblasts
CCTGCATGTTGTGCCG-1	Fibroblasts
CCTGCATTCAGCGCAC-1	Fibroblasts
CCTGCATTCCAAACCA-1	Epithelial cells
CCTGTTGAGGCTCAAG-1	Fibroblasts
CCTGTTGCAGGACGAT-1	NK cells
CCTGTTGCAGGTCAAG-1	ILC
CCTGTTGTCGTGTCAA-1	Epithelial cells
CCTTCAGAGTTGCGCC-1	Fibroblasts
CCTTCAGGTATCACCA-1	Macrophages
CCTTCAGTCGGCATCG-1	Epithelial cells
CCTTCAGTCTGACGCG-1	T cells
CCTTGTGAGCGGCTCT-1	Epithelial cells
CCTTGTGAGCTAGATA-1	Epithelial cells
CCTTGTGCAATGCAAA-1	T cells
CCTTGTGCAGATGCGA-1	Fibroblasts
CCTTGTGCATAAGATG-1	B cells
CCTTGTGGTACTCCCT-1	DC
CCTTGTGGTACTGCGC-1	Fibroblasts
CCTTGTGGTGGTTTGT-1	T cells
CCTTGTGTCTGCATAG-1	T cells
CCTTTGGAGACTCAAA-1	Macrophages
CCTTTGGCAAACTAAG-1	Fibroblasts
CCTTTGGCAATGTTGC-1	Monocytes
CCTTTGGTCGCCTTTG-1	Epithelial cells
CCTTTGGTCGCGTTTC-1	T cells
CGAAGGAAGATCGCCC-1	Fibroblasts
CGAAGGAAGCTCCCTT-1	Fibroblasts
CGAAGGACATGAGATA-1	T cells
CGAAGGACATGGAGAC-1	Macrophages
CGAAGGAGTATTCCTT-1	Fibroblasts
CGAAGGAGTCGCCTAG-1	Monocytes
CGAAGGAGTCTACACA-1	Macrophages
CGAAGGATCATTGTTC-1	T cells
CGAAGTTTCTCCCATG-1	T cells
CGAATTGAGGATACCG-1	T cells
CGAATTGAGTCACAGG-1	T cells
CGAATTGAGTCCGCGT-1	Endothelial cells
CGAATTGAGTCGAGGT-1	T cells
CGAATTGGTCTGTGCG-1	Fibroblasts
CGAATTGTCTCTATGT-1	T cells
CGAATTGTCTTGGCTC-1	T cells
CGACAGCAGACTTCCA-1	Endothelial cells
CGACAGCAGCTAAATG-1	Monocytes
CGACAGCCATGGCGCT-1	ILC
CGACAGCCATGTCGTA-1	Fibroblasts
CGACAGCGTGGTACAG-1	DC
CGACAGCGTTCTTGTT-1	Macrophages
CGACAGCTCACTGTCC-1	Monocytes
CGACAGCTCATACGGT-1	T cells
CGACAGCTCGCCAATA-1	Fibroblasts
CGACAGCTCTCCACTG-1	Epithelial cells
CGACAGCTCTGACAGT-1	Fibroblasts
CGAGAAGAGGATTACA-1	Epithelial cells
CGAGAAGCAACACAAA-1	Macrophages
CGAGAAGCAACCGATT-1	T cells
CGAGAAGGTGACGCCT-1	NK cells
CGAGAAGTCCTTCAGC-1	Macrophages
CGAGAAGTCGACATAC-1	Fibroblasts
CGAGGAAAGGCGTTAG-1	Epithelial cells
CGAGGAACACTTGACA-1	T cells
CGAGGAACATACCGTA-1	Fibroblasts
CGAGGAAGTCACCTTC-1	Fibroblasts
CGAGGAATCGCCTAGG-1	Fibroblasts
CGAGGCTAGCACTCAT-1	Epithelial cells
CGAGGCTAGCTGGCTC-1	Fibroblasts
CGAGGCTAGGTAGTCG-1	Epithelial cells
CGAGGCTAGTCAGGGT-1	Epithelial cells
CGAGGCTCAAGTCGTT-1	T cells
CGAGGCTCACGGTGAA-1	Monocytes
CGAGGCTCAGAAGTGC-1	Macrophages
CGAGGCTGTTTGTTGG-1	T cells
CGAGGCTTCAAAGGTA-1	T cells
CGAGGCTTCACTTATC-1	T cells
CGAGGCTTCATTTGGG-1	Fibroblasts
CGAGGCTTCGCACGAC-1	B cells
CGAGGCTTCTTGGCTC-1	Plasma cells
CGAGTGCAGCTGTCCG-1	B cells
CGAGTGCCACGGTGCT-1	DC
CGAGTGCTCTCGAGTA-1	ILC
CGAGTGCTCTGGCTGG-1	T cells
CGAGTTAAGGAGCTGT-1	Monocytes
CGAGTTAAGTGGAAGA-1	DC
CGAGTTACAAATAGCA-1	Fibroblasts
CGAGTTACACCTCTAC-1	pDC
CGAGTTAGTACTGAGG-1	T cells
CGAGTTATCCGTTGGG-1	Endothelial cells
CGAGTTATCCTCCACA-1	T cells
CGAGTTATCGAGGCAA-1	Epithelial cells
CGATCGGAGCTCAGAG-1	T cells
CGATCGGGTAGTCTTG-1	T cells
CGATCGGGTTGATGTC-1	Epithelial cells
CGATCGGTCGTGTCAA-1	Plasma cells
CGATGCGAGGCGCTCT-1	T cells
CGATGCGAGGGTCACA-1	ILC
CGATGCGCATTGACAC-1	T cells
CGATGCGGTCTTCGAA-1	T cells
CGATGGCAGAACCGCA-1	NK cells
CGATGGCAGGTTCCAT-1	Fibroblasts
CGATGGCCACGCGTCA-1	NK cells
CGATGGCCATGGTACT-1	ILC
CGATGGCGTGCATGTT-1	Fibroblasts
CGATGGCGTGTCTCCT-1	Fibroblasts
CGCAGGTAGACCTCCG-1	Fibroblasts
CGCAGGTAGGCTTCCG-1	pDC
CGCAGGTAGGGCAGAG-1	Fibroblasts
CGCAGGTAGTGTCATC-1	Macrophages
CGCAGGTCACTAACCA-1	T cells
CGCAGGTCAGAGATTA-1	T cells
CGCAGGTCAGGTTTAC-1	Fibroblasts
CGCAGGTGTTGGGATG-1	Mast cells
CGCAGGTTCAAAGAAC-1	Fibroblasts
CGCAGGTTCATCGCAA-1	Fibroblasts
CGCAGGTTCTCAGTCC-1	Monocytes
CGCAGGTTCTGTGCTC-1	T cells
CGCATAAAGATGCAGC-1	T cells
CGCATAAAGTTCGCAT-1	Endothelial cells
CGCATAACACCAGGTC-1	T cells
CGCATAACAGGCGATA-1	T cells
CGCATAAGTTGCACGC-1	NK cells
CGCATAATCTCGACCT-1	T cells
CGCATGGAGCCACTCG-1	T cells
CGCATGGAGGAGACCT-1	Endothelial cells
CGCATGGCAACGCCCA-1	T cells
CGCATGGGTACCAATC-1	Monocytes
CGCATGGGTACGGATG-1	Macrophages
CGCATGGTCCGATCGG-1	T cells
CGCATGGTCTCTAAGG-1	Monocytes
CGCATGGTCTGGACCG-1	Epithelial cells
CGCCAGAAGTGATCGG-1	NK cells
CGCCAGACACTATCGA-1	Monocytes
CGCCAGACATACCGTA-1	T cells
CGCCAGAGTATGGTTC-1	Fibroblasts
CGCCAGATCATCCTAT-1	Fibroblasts
CGCCAGATCTCCGTGT-1	Monocytes
CGCCATTAGACATCAA-1	B cells
CGCCATTAGGTCCCTG-1	Fibroblasts
CGCCATTAGTCCGTCG-1	Fibroblasts
CGCCATTAGTGGATTA-1	pDC
CGCCATTGTCACCCTT-1	Fibroblasts
CGCCATTTCGATACAC-1	Fibroblasts
CGCGTGAAGCATCTTG-1	Fibroblasts
CGCGTGAGTCGAAACG-1	Endothelial cells
CGCGTGATCAGGACAG-1	Monocytes
CGCGTGATCGCGTGAC-1	Fibroblasts
CGGAACCAGGACGGAG-1	Fibroblasts
CGGAACCAGGGAGTTC-1	Epithelial cells
CGGAACCCATCAGTCA-1	T cells
CGGAACCCATGATGCT-1	T cells
CGGAACCGTAAGATAC-1	Fibroblasts
CGGAACCGTACCGGCT-1	NK cells
CGGAACCGTATCTCGA-1	Epithelial cells
CGGAACCGTCGTCAGC-1	T cells
CGGAACCTCAAAGCCT-1	Monocytes
CGGAACCTCTCTGACC-1	T cells
CGGAATTAGCATGCAG-1	Fibroblasts
CGGAATTAGTCGCCAC-1	T cells
CGGAATTCAAGGCCTC-1	Epithelial cells
CGGAATTCAGCCATTA-1	T cells
CGGAATTTCATTACGG-1	Epithelial cells
CGGAATTTCATTCGGA-1	Fibroblasts
CGGAATTTCTACCACC-1	Epithelial cells
CGGACACCAGCGGTTC-1	T cells
CGGACACGTGATACTC-1	Fibroblasts
CGGACACGTGTTCGAT-1	Monocytes
CGGACACTCGCCCAGA-1	Epithelial cells
CGGAGAAAGTTCATCG-1	Epithelial cells
CGGAGAACAAGTAGTA-1	Monocytes
CGGAGAACAGACATCT-1	Fibroblasts
CGGAGAACAGGCCTGT-1	Endothelial cells
CGGAGAAGTATGAGAT-1	Epithelial cells
CGGAGAAGTCACAGTT-1	Fibroblasts
CGGAGAAGTGTTTACG-1	Monocytes
CGGCAGTCAAAGGCGT-1	Fibroblasts
CGGCAGTCACCGTCGA-1	Fibroblasts
CGGCAGTGTAACATAG-1	B cells
CGGCAGTGTGTCTAAC-1	Fibroblasts
CGGGACTAGCCGTTAT-1	Fibroblasts
CGGGACTCACATGGTT-1	Monocytes
CGGGACTCATCATGAC-1	Endothelial cells
CGGGACTGTCGTGATT-1	T cells
CGGGACTGTTCTATCT-1	Epithelial cells
CGGGACTTCTCGAACA-1	Epithelial cells
CGGGCATAGTCGTTAC-1	NK cells
CGGGCATAGTCTTCCC-1	Fibroblasts
CGGGCATTCACTGAAC-1	T cells
CGGGCATTCTTGGATG-1	pDC
CGGGTCAAGATGCTAA-1	Fibroblasts
CGGGTCAAGCACCCAC-1	Fibroblasts
CGGGTCAAGCTCCCTT-1	Epithelial cells
CGGGTCATCCGTGTCT-1	Monocytes
CGGGTGTAGCACTCAT-1	Epithelial cells
CGGGTGTAGTTGAAAC-1	Macrophages
CGGGTGTCACTGAGTT-1	T cells
CGGGTGTGTCGAACAG-1	T cells
CGGGTGTTCCGAGCTG-1	T cells
CGGGTGTTCGAGATGG-1	Monocytes
CGGGTGTTCTAGTGAC-1	Epithelial cells
CGGTCAGAGCCTCAAT-1	DC
CGGTCAGAGGGATCTG-1	Fibroblasts
CGGTCAGCAACTCCCT-1	Fibroblasts
CGGTCAGCAGTCAGTT-1	T cells
CGGTCAGCATGAGAAT-1	Epithelial cells
CGGTCAGCATTCACCC-1	B cells
CGGTCAGGTATCGGTT-1	Epithelial cells
CGGTCAGGTCATCTAG-1	Macrophages
CGGTCAGGTTATTCTC-1	Monocytes
CGGTCAGTCTCACGAA-1	Macrophages
CGGTCAGTCTGAATCG-1	Epithelial cells
CGTAAGTAGCCTCACG-1	Fibroblasts
CGTAAGTGTACGATTC-1	Fibroblasts
CGTAAGTGTACTGCGC-1	Macrophages
CGTAAGTTCCGAAATC-1	Fibroblasts
CGTAAGTTCTTCGATT-1	Epithelial cells
CGTAATGAGCAGGTCA-1	Monocytes
CGTAATGAGTGAGGTC-1	T cells
CGTAATGGTCCACTTC-1	Macrophages
CGTAATGGTGCATGTT-1	Epithelial cells
CGTAATGGTTAAAGTG-1	T cells
CGTAATGGTTGACGGA-1	T cells
CGTAGTAAGAGGTCGT-1	pDC
CGTAGTACAAGCTACT-1	T cells
CGTAGTACAGATACTC-1	Epithelial cells
CGTCAAAAGACGCATG-1	Fibroblasts
CGTCAAACATCGCCTT-1	pDC
CGTCAAAGTTAGGGTG-1	T cells
CGTCCATAGTCTTCCC-1	DC
CGTCCATAGTTGCATC-1	Endothelial cells
CGTCCATCACGTCTCT-1	T cells
CGTCCATGTCGTGATT-1	DC
CGTCCATTCACCTGTC-1	Fibroblasts
CGTCCATTCCGGCTTT-1	B cells
CGTCCATTCTAAGGAA-1	T cells
CGTCCATTCTGGAGAG-1	T cells
CGTGAATAGAGCAGAA-1	Fibroblasts
CGTGAATAGAGTCTGG-1	T cells
CGTGAATCACTGCATA-1	Endothelial cells
CGTGAATCAGGTATGG-1	Epithelial cells
CGTGAATGTAATCAGA-1	Macrophages
CGTGATAAGACATCCT-1	Monocytes
CGTGATAAGCCATTTG-1	Macrophages
CGTGATAAGCGCATCC-1	T cells
CGTGATAGTATGGAGC-1	pDC
CGTGATATCGATAACC-1	T cells
CGTGATATCTGCGATA-1	Fibroblasts
CGTGCTTAGACGGTTG-1	Macrophages
CGTGCTTAGAGCAGAA-1	Monocytes
CGTGCTTAGTTGGCGA-1	Fibroblasts
CGTGCTTCAAAGAGTT-1	Epithelial cells
CGTGCTTGTATGGTAA-1	Epithelial cells
CGTGCTTGTCTGTAAC-1	Monocytes
CGTGCTTGTGCTCGTG-1	Epithelial cells
CGTGCTTGTTCAAGTC-1	Fibroblasts
CGTGCTTTCCAGCACG-1	Fibroblasts
CGTGCTTTCTCCATAT-1	T cells
CGTGTCTAGGCTGGAT-1	B cells
CGTGTCTCACGCGTCA-1	Macrophages
CGTGTCTCATTCTGTT-1	Endothelial cells
CGTGTCTGTTATAGCC-1	Fibroblasts
CGTGTCTTCACTGTCC-1	Fibroblasts
CGTTAGAAGTCAGCGA-1	Mast cells
CGTTAGACAATCCAGT-1	T cells
CGTTAGAGTGTCCACG-1	Monocytes
CGTTAGAGTTAGCGGA-1	Monocytes
CGTTAGATCCCTGTTG-1	ILC
CGTTAGATCTAGATCG-1	DC
CGTTCTGAGACCATTC-1	NK cells
CGTTCTGCACAGACGA-1	T cells
CGTTCTGCACCGCTGA-1	Epithelial cells
CGTTCTGCACTCACTC-1	T cells
CGTTCTGCAGTTCTAG-1	Fibroblasts
CGTTCTGTCCCTCGAT-1	Epithelial cells
CGTTCTGTCTCACCCA-1	Fibroblasts
CGTTGGGAGTATGACA-1	Epithelial cells
CGTTGGGGTGCGTCGT-1	Fibroblasts
CGTTGGGTCCAACTGA-1	T cells
CTAACCCAGGTCACCC-1	T cells
CTAACCCAGTGATTCC-1	Fibroblasts
CTAACCCCAGGCATTT-1	T cells
CTAACCCCATCCCACT-1	Monocytes
CTAACCCGTGCGTGCT-1	Epithelial cells
CTAACCCGTGTAGTGG-1	Macrophages
CTAACTTAGCTCAGAG-1	T cells
CTAACTTAGGATCATA-1	Fibroblasts
CTAACTTCAGGCAATG-1	Epithelial cells
CTAAGTGAGCGCTGCT-1	Monocytes
CTAAGTGAGGACAGCT-1	Monocytes
CTAAGTGAGTGGTTAA-1	pDC
CTAAGTGGTACGCGTC-1	Monocytes
CTAAGTGGTCCCTAAA-1	T cells
CTAAGTGGTGACCGTC-1	ILC
CTAAGTGGTTGTGTTG-1	Monocytes
CTACAGAAGAGCAGTC-1	pDC
CTACAGAAGGAGATAG-1	T cells
CTACAGAAGTGCAGCA-1	NK cells
CTACAGAAGTTGCTGT-1	T cells
CTACAGACAATACAGA-1	Epithelial cells
CTACAGACACTTCAGA-1	Fibroblasts
CTACAGACAGAAATCA-1	T cells
CTACAGACAGGCTTGC-1	T cells
CTACAGACAGTCGGTC-1	Fibroblasts
CTACAGAGTGTGTTTG-1	DC
CTACAGATCAACTACG-1	Monocytes
CTACAGATCACCATAG-1	T cells
CTACAGATCTAAGAAG-1	T cells
CTACATTAGAGGCTGT-1	Fibroblasts
CTACATTAGATCCTAC-1	Epithelial cells
CTACATTCATCCAATG-1	NK cells
CTACATTTCGGATACT-1	Epithelial cells
CTACCCAAGGATTCAA-1	Fibroblasts
CTACCCACATGGAGAC-1	T cells
CTACCCATCACTACTT-1	T cells
CTACCCATCATGCTAG-1	Fibroblasts
CTACCCATCCATATGG-1	B cells
CTACCCATCGTCGCTT-1	Fibroblasts
CTACCTGAGACCAGAC-1	Monocytes
CTACCTGAGGGAACAA-1	Macrophages
CTACCTGCAGCGAACA-1	Epithelial cells
CTACCTGTCAACGAGG-1	Endothelial cells
CTACCTGTCTAACGCA-1	Macrophages
CTACCTGTCTTTGATC-1	Epithelial cells
CTACGGGAGAAACCCG-1	Epithelial cells
CTACGGGAGGGATCAC-1	T cells
CTACGGGCAAGCGCAA-1	Epithelial cells
CTACGGGCACGATTCA-1	Plasma cells
CTACGGGGTGGTTTGT-1	Endothelial cells
CTACGGGTCCATATGG-1	Epithelial cells
CTACGGGTCTACTGCC-1	T cells
CTACTATAGGCTTAAA-1	Fibroblasts
CTACTATTCATACGAC-1	Fibroblasts
CTACTATTCATGCTAG-1	T cells
CTACTATTCCCGAGGT-1	Fibroblasts
CTACTATTCCGTGGTG-1	B cells
CTACTATTCGGTCGAC-1	Fibroblasts
CTACTATTCTGCTGAA-1	T cells
CTAGACAAGCGTTACT-1	Macrophages
CTAGACATCGCTCCTA-1	T cells
CTAGACATCTCTTCAA-1	Fibroblasts
CTAGACATCTTTCCGG-1	Epithelial cells
CTAGGTAAGAGAGTTT-1	Epithelial cells
CTAGGTAAGTATCCTG-1	B cells
CTAGGTAGTATGCGGA-1	Monocytes
CTAGGTATCCGTTGAA-1	pDC
CTAGGTATCGCGTGAC-1	T cells
CTAGGTATCGTGCTCT-1	Endothelial cells
CTAGGTATCTAGACCA-1	Fibroblasts
CTATAGGAGCTACGTT-1	T cells
CTATAGGAGTATGCAA-1	Epithelial cells
CTATAGGAGTCACAGG-1	T cells
CTATAGGCAACTGAAA-1	T cells
CTATAGGCAAGTGGGT-1	T cells
CTATAGGGTACTCGAT-1	Fibroblasts
CTATAGGGTTCGTTCC-1	Fibroblasts
CTATAGGTCCACTGAA-1	T cells
CTATCCGCAGAGAGGG-1	Epithelial cells
CTATCCGCATCGTGCG-1	Macrophages
CTATCCGCATGGAGAC-1	Monocytes
CTATCTAAGAAGCCAC-1	Monocytes
CTATCTAAGTATGGAT-1	Fibroblasts
CTATCTACAATCTAGC-1	Endothelial cells
CTATCTACAATTTCTC-1	Epithelial cells
CTATCTACAGGATCTT-1	Monocytes
CTATCTAGTGTCACAT-1	pDC
CTATCTAGTTACACTG-1	T cells
CTATCTAGTTCCGCTT-1	T cells
CTCAACCAGATGAACT-1	Endothelial cells
CTCAACCCAACGGCTC-1	Epithelial cells
CTCAACCCAAGCTCTA-1	T cells
CTCAACCCACAGCCAC-1	T cells
CTCAACCCACGTAGTT-1	Fibroblasts
CTCAACCTCCCGAGTG-1	T cells
CTCAACCTCCGAAGGA-1	T cells
CTCAAGAAGGCTTAAA-1	Epithelial cells
CTCAAGAAGTTTAGGA-1	Fibroblasts
CTCAAGACAACAGCCC-1	Epithelial cells
CTCAAGACAATGACCT-1	Epithelial cells
CTCAATTAGCAGCCTC-1	T cells
CTCAATTGTCAGTCCG-1	T cells
CTCACTGAGCTGACCC-1	Epithelial cells
CTCACTGCAACAGCTT-1	Macrophages
CTCACTGCAAGTGGAC-1	Macrophages
CTCACTGCAATTGGTC-1	T cells
CTCACTGTCGGACTTA-1	Fibroblasts
CTCAGAAAGCTCTGTA-1	ILC
CTCAGAACAAATGGCG-1	T cells
CTCAGAACAGTTTCAG-1	DC
CTCAGAACATGACGTT-1	DC
CTCAGAAGTAGGTTTC-1	Monocytes
CTCAGAAGTAGTCGGA-1	Monocytes
CTCAGAAGTCTAACTG-1	pDC
CTCAGAAGTGCCTAAT-1	Epithelial cells
CTCAGAATCCTTCTTC-1	Macrophages
CTCAGAATCGCAGTGC-1	Monocytes
CTCAGGGAGGAGTACC-1	T cells
CTCAGGGAGTTGGAGC-1	Fibroblasts
CTCAGGGGTAACTGCT-1	Fibroblasts
CTCAGGGGTCCTTAAG-1	Fibroblasts
CTCAGGGGTGAGATTA-1	Endothelial cells
CTCAGGGGTTCTAAGC-1	Macrophages
CTCAGGGTCCCTCAAC-1	Fibroblasts
CTCAGTCAGCATCAAA-1	Fibroblasts
CTCAGTCAGTGTTGAA-1	T cells
CTCAGTCCAAGCACAG-1	Fibroblasts
CTCAGTCCACAAAGCG-1	Macrophages
CTCAGTCGTACGATGG-1	Fibroblasts
CTCATCGAGTTACGAA-1	Fibroblasts
CTCATCGCAAAGTGTA-1	Epithelial cells
CTCATCGCACCCTAAA-1	Epithelial cells
CTCATCGGTTGGCTAT-1	Epithelial cells
CTCATCGTCGACGACC-1	T cells
CTCATCGTCTGTTCAT-1	T cells
CTCATGCAGAAGTGTT-1	Endothelial cells
CTCATGCAGTAAGACT-1	Macrophages
CTCATGCCACGAAGAC-1	Epithelial cells
CTCATGCCACTACGGC-1	Fibroblasts
CTCATGCGTCAGCTTA-1	Endothelial cells
CTCATGCTCAGTGTTG-1	B cells
CTCATGCTCGCGCCAA-1	B cells
CTCATTAAGCCTGGAA-1	Macrophages
CTCATTACACAAGCTT-1	DC
CTCATTAGTATCACCA-1	T cells
CTCATTAGTATGTCAC-1	DC
CTCCAACAGACTACGG-1	T cells
CTCCAACAGCGGATCA-1	Epithelial cells
CTCCAACCAACGTATC-1	T cells
CTCCAACCACCTATCC-1	Fibroblasts
CTCCAACGTTCTCGCT-1	Epithelial cells
CTCCAACTCAGGAACG-1	DC
CTCCAACTCATCGCCT-1	Epithelial cells
CTCCAACTCCAGCTCT-1	B cells
CTCCAACTCGAGAGAC-1	Fibroblasts
CTCCAACTCTCTGGTC-1	DC
CTCCAACTCTGATGGT-1	T cells
CTCCACAAGCATACTC-1	T cells
CTCCACACAACTGCCG-1	Epithelial cells
CTCCACACACGCGCTA-1	Epithelial cells
CTCCATGAGGGCTTCC-1	T cells
CTCCATGAGTAGAGTT-1	Epithelial cells
CTCCATGAGTCCGTCG-1	T cells
CTCCATGTCCAACACA-1	Endothelial cells
CTCCATGTCCCGAAAT-1	Monocytes
CTCCCAAAGTCAATCC-1	T cells
CTCCCAACACAAACGG-1	Macrophages
CTCCCAACACGGATCC-1	pDC
CTCCCAACAGCTTTGA-1	Endothelial cells
CTCCCAAGTATTGAGA-1	T cells
CTCCCAATCACGTCCT-1	Epithelial cells
CTCCCTCCAAAGACTA-1	ILC
CTCCCTCGTAACATCC-1	ILC
CTCCCTCGTCAATCTG-1	Epithelial cells
CTCCCTCTCATGCCGG-1	Endothelial cells
CTCCGATAGTCACTAC-1	Endothelial cells
CTCCGATAGTTATGGA-1	pDC
CTCCGATCAGTTTCGA-1	Fibroblasts
CTCCTCCAGAGAAGGT-1	DC
CTCCTCCAGTCACTCA-1	Fibroblasts
CTCCTCCCAACGACAG-1	Monocytes
CTCCTCCCAATCGCAT-1	Plasma cells
CTCCTCCGTATGAGCG-1	Epithelial cells
CTCCTCCGTTAAAGTG-1	Fibroblasts
CTCCTCCGTTCCACAA-1	Endothelial cells
CTCCTCCTCAGACCTA-1	DC
CTCCTCCTCCTCTAGC-1	Epithelial cells
CTCCTCCTCGACATTG-1	Fibroblasts
CTCCTTTAGATACTGA-1	Monocytes
CTCCTTTAGGTGTGAC-1	Epithelial cells
CTCCTTTCAATCTGCA-1	T cells
CTCCTTTCAGTAGAGC-1	Epithelial cells
CTCCTTTCAGTAGTTC-1	T cells
CTCCTTTGTACGTACT-1	Fibroblasts
CTCCTTTGTAGCTGTT-1	Fibroblasts
CTCCTTTGTCTACAAC-1	Epithelial cells
CTCCTTTGTGTAGTGG-1	T cells
CTCCTTTGTTGTGTTG-1	T cells
CTCCTTTTCATGAGAA-1	Fibroblasts
CTCCTTTTCCGAGGCT-1	Epithelial cells
CTCCTTTTCGAGAATA-1	Fibroblasts
CTCCTTTTCTGAGGCC-1	Fibroblasts
CTCGAGGCACTCCTGT-1	Fibroblasts
CTCGAGGCATGTGCCG-1	Fibroblasts
CTCGAGGGTAACACCT-1	Fibroblasts
CTCGAGGTCGCAATGT-1	T cells
CTCTCAGAGTGTTGAA-1	T cells
CTCTCAGCACACCGAC-1	Fibroblasts
CTCTCAGCAGTGGCTC-1	T cells
CTCTCAGCATCGAACT-1	Epithelial cells
CTCTCAGGTAAGGCTG-1	Epithelial cells
CTCTCAGTCGTAGGAG-1	T cells
CTCTCGAAGATCACCT-1	Macrophages
CTCTCGAAGCAGGCTA-1	Fibroblasts
CTCTCGACACTATCGA-1	Monocytes
CTCTCGAGTGTTTCTT-1	Macrophages
CTCTCGATCTTCGACC-1	Plasma cells
CTCTGGTAGATTCGCT-1	Fibroblasts
CTCTGGTGTCGGTGAA-1	Fibroblasts
CTCTGGTTCAAGCTGT-1	B cells
CTGAATGAGCGTACAG-1	T cells
CTGAATGAGTCACTAC-1	Fibroblasts
CTGAATGGTGACTCGC-1	Endothelial cells
CTGAATGTCAGACAAA-1	Fibroblasts
CTGAATGTCCAACCGG-1	Monocytes
CTGAATGTCCTTTGAT-1	Epithelial cells
CTGAATGTCGCATAGT-1	T cells
CTGAGCGAGACGGTTG-1	Epithelial cells
CTGAGCGCACAACGTT-1	Endothelial cells
CTGAGCGCACGTCGTG-1	T cells
CTGAGCGCAGACGATG-1	T cells
CTGAGCGCAGCCTACG-1	Fibroblasts
CTGAGCGGTAGACACG-1	T cells
CTGAGCGGTGTTGATC-1	Monocytes
CTGAGCGTCTGGACCG-1	Macrophages
CTGAGGCAGAATTCAG-1	Epithelial cells
CTGAGGCAGCGAACTG-1	Fibroblasts
CTGAGGCAGTCAACAA-1	Endothelial cells
CTGAGGCCAAATCAGA-1	Endothelial cells
CTGAGGCCACCAGCCA-1	Fibroblasts
CTGAGGCGTATGTGTC-1	T cells
CTGATCCCAACCAACT-1	T cells
CTGCAGGAGTCCCGAC-1	Endothelial cells
CTGCAGGCACGATTCA-1	Fibroblasts
CTGCAGGGTACAACGG-1	T cells
CTGCAGGTCTGCCCTA-1	T cells
CTGCATCCACGGTGCT-1	Macrophages
CTGCATCGTGCGGTAA-1	T cells
CTGCATCGTGTAAACA-1	Fibroblasts
CTGCATCGTTGCAAGG-1	Fibroblasts
CTGCATCTCCTTCTTC-1	T cells
CTGCATCTCGATTCCC-1	T cells
CTGCCATAGGCATTTC-1	T cells
CTGCCATCAGACAAAT-1	Fibroblasts
CTGCCATGTAACTGCT-1	Fibroblasts
CTGCCATGTAGCACGA-1	Epithelial cells
CTGCCATGTCTAGATC-1	Fibroblasts
CTGCCATTCCAAAGGG-1	Fibroblasts
CTGCCTAAGAGCCGAT-1	T cells
CTGCCTAAGTCATGCT-1	Fibroblasts
CTGCCTACAAAGGCAC-1	pDC
CTGCCTACAGTGGTGA-1	T cells
CTGCCTACATCAGCGC-1	Epithelial cells
CTGCCTACATTCAGGT-1	Fibroblasts
CTGCCTAGTACGTACT-1	T cells
CTGCCTAGTCAAGGCA-1	Epithelial cells
CTGCGAGTCACTGTTT-1	DC
CTGCGAGTCATAGGCT-1	Epithelial cells
CTGCGAGTCCAAGGGA-1	Epithelial cells
CTGCGAGTCGAGTCTA-1	Fibroblasts
CTGCTCAAGCAATTAG-1	Epithelial cells
CTGCTCAAGTCACGAG-1	Fibroblasts
CTGCTCACAGGCATGA-1	Epithelial cells
CTGCTCATCAAAGAAC-1	Monocytes
CTGGACGCAAGTACCT-1	Fibroblasts
CTGGACGCATGTCTAG-1	Fibroblasts
CTGGACGCATGTGCCG-1	NK cells
CTGGACGGTACATACC-1	pDC
CTGGACGGTAGCTGTT-1	Epithelial cells
CTGGACGGTCCAAAGG-1	Fibroblasts
CTGGACGGTGCTCTTC-1	Fibroblasts
CTGGACGTCCGATGCG-1	Fibroblasts
CTGGCAGAGCATCTTG-1	Fibroblasts
CTGGCAGAGCCGATCC-1	T cells
CTGGCAGAGCCGTTAT-1	ILC
CTGGCAGCATACTGAC-1	T cells
CTGGCAGTCACCCTGT-1	Endothelial cells
CTGGCAGTCGCTAGCG-1	Epithelial cells
CTGGTCTAGAAATCCA-1	T cells
CTGGTCTAGGAATCGC-1	Endothelial cells
CTGGTCTAGTTTCTTC-1	Fibroblasts
CTGGTCTAGTTTGAGA-1	Endothelial cells
CTGGTCTCAAACTCGT-1	Fibroblasts
CTGGTCTCAAAGGATT-1	T cells
CTGGTCTCAGAAACCG-1	Fibroblasts
CTGGTCTCATGACACT-1	T cells
CTGGTCTGTAAGATCA-1	T cells
CTGGTCTGTGTAGCAG-1	T cells
CTGTACCAGGTACAGC-1	Epithelial cells
CTGTACCAGGTTCAGG-1	Endothelial cells
CTGTACCCAAGACTGG-1	T cells
CTGTACCGTCGTATGT-1	Epithelial cells
CTGTACCGTCGTGGTC-1	Fibroblasts
CTGTACCGTTTGGAGG-1	Mast cells
CTGTACCTCACCGACG-1	B cells
CTGTACCTCCCAAGCG-1	Fibroblasts
CTGTAGACACTTCATT-1	Epithelial cells
CTGTAGAGTTGGTGTT-1	B cells
CTGTAGATCCCTCATG-1	Monocytes
CTGTAGATCGGAGCAA-1	Endothelial cells
CTGTAGATCTCTCGCA-1	Fibroblasts
CTGTATTAGGCTAGCA-1	Fibroblasts
CTGTATTAGGTCTACT-1	Macrophages
CTGTATTAGGTCTTTG-1	T cells
CTGTATTCATCATCTT-1	Fibroblasts
CTGTATTCATGGAAGC-1	B cells
CTGTATTCATTCACCC-1	Macrophages
CTGTATTCATTCGATG-1	T cells
CTGTATTGTCGAGATG-1	Epithelial cells
CTGTCGTAGCCTCTCT-1	Epithelial cells
CTGTCGTCACCCTTGT-1	T cells
CTGTCGTCACGACTAT-1	B cells
CTGTCGTCACTTCAAG-1	Epithelial cells
CTGTCGTCAGGGTTGA-1	T cells
CTGTCGTGTGCATTAC-1	Fibroblasts
CTGTCGTGTGGTTCTA-1	Endothelial cells
CTGTCGTGTTCTCTAT-1	T cells
CTGTCGTTCACGGGAA-1	NK cells
CTGTCGTTCTACACAG-1	Fibroblasts
CTGTCGTTCTCTAGGA-1	Epithelial cells
CTGTGAAAGAATCGCG-1	Monocytes
CTGTGAACAATAGGGC-1	Fibroblasts
CTGTGAAGTAGGATAT-1	Macrophages
CTGTGAAGTAGGTAGC-1	Fibroblasts
CTGTGAAGTTTCGACA-1	T cells
CTGTGAATCGTAATGC-1	Fibroblasts
CTGTGGGCAAGGTACG-1	Fibroblasts
CTGTGGGCAGGCTACC-1	Fibroblasts
CTGTGGGGTCAGGTGA-1	Epithelial cells
CTGTGGGTCGCACTCT-1	ILC
CTGTGGGTCGTGGCTG-1	Mast cells
CTTACCGAGCACCCAC-1	Fibroblasts
CTTACCGAGGCTCTCG-1	T cells
CTTACCGAGTAAACAC-1	Epithelial cells
CTTACCGCAGAGAATT-1	Epithelial cells
CTTACCGCATCACAGT-1	Monocytes
CTTACCGGTAACATAG-1	Fibroblasts
CTTACCGGTCTAATCG-1	pDC
CTTACCGTCCCGAGAC-1	Fibroblasts
CTTACCGTCCGATGCG-1	Endothelial cells
CTTACCGTCCGCAGTG-1	T cells
CTTACCGTCGTCGACG-1	Endothelial cells
CTTAGGACAGCTACAT-1	Plasma cells
CTTAGGATCCATACAG-1	T cells
CTTAGGATCGACGCTG-1	Fibroblasts
CTTCAATAGGGATGTC-1	T cells
CTTCAATGTTTAAGGA-1	T cells
CTTCAATGTTTAGACC-1	Fibroblasts
CTTCAATTCGAAGCAG-1	pDC
CTTCAATTCTCGCGTT-1	Fibroblasts
CTTCAATTCTCTTAAC-1	Fibroblasts
CTTCCGAAGAACTGAT-1	Fibroblasts
CTTCCGAAGCAATTCC-1	Macrophages
CTTCCGACACGCTGTG-1	Epithelial cells
CTTCCGACATGTTCGA-1	Epithelial cells
CTTCCGAGTATTGAGA-1	T cells
CTTCCGAGTCATAACC-1	T cells
CTTCCGATCCCGAGAC-1	Fibroblasts
CTTCCGATCTAGGCCG-1	Epithelial cells
CTTCCTTAGCGATGAC-1	NK cells
CTTCCTTAGGTTGCCC-1	Monocytes
CTTCCTTAGTAATACG-1	T cells
CTTCCTTAGTGCAGGT-1	Epithelial cells
CTTCCTTAGTTGAAGT-1	T cells
CTTCCTTCAGACCATT-1	T cells
CTTCCTTCATCTATCT-1	T cells
CTTCCTTGTAGGATAT-1	Monocytes
CTTCCTTGTGCTCTCT-1	Monocytes
CTTCCTTTCGATTTCT-1	Fibroblasts
CTTCGGTAGCTGTTAC-1	Monocytes
CTTCGGTCACGAGGTA-1	Endothelial cells
CTTCGGTCACGTTCGG-1	Fibroblasts
CTTCGGTCAGACAATA-1	T cells
CTTCGGTCAGGTTCCG-1	T cells
CTTCGGTGTCACCACG-1	Epithelial cells
CTTCGGTTCACCTGGG-1	T cells
CTTCGGTTCCCGAGTG-1	Epithelial cells
CTTCGGTTCGGTCGGT-1	Fibroblasts
CTTCGGTTCGTAGGGA-1	Monocytes
CTTCTAAAGAGGTCAC-1	Epithelial cells
CTTCTAAAGGTACAGC-1	Epithelial cells
CTTCTAAAGTACCGGA-1	DC
CTTCTAAAGTCTTGGT-1	Epithelial cells
CTTCTAATCACTCGAA-1	DC
CTTCTCTAGTCGCTAT-1	Fibroblasts
CTTCTCTCACTTCAGA-1	T cells
CTTCTCTCATATAGCC-1	Epithelial cells
CTTCTCTGTCCGACGT-1	Macrophages
CTTCTCTGTGGAAATT-1	pDC
CTTGAGAAGAGTCTTC-1	Epithelial cells
CTTGAGAAGGGTCACA-1	T cells
CTTGAGAAGTTACGGG-1	T cells
CTTGAGACAGAAGCTG-1	DC
CTTGAGACAGCGAGTA-1	Macrophages
CTTGAGACAGGCATGA-1	T cells
CTTGAGAGTAATCAGA-1	Fibroblasts
CTTGAGATCCGGTAGC-1	T cells
CTTGATTAGATTAGCA-1	T cells
CTTGATTGTCGAGCTC-1	T cells
CTTGATTTCCGTGGCA-1	T cells
CTTTCAAAGATACTGA-1	T cells
CTTTCAACAAACTGCT-1	T cells
CTTTCAATCCGTAGTA-1	Fibroblasts
CTTTCAATCGCAGTGC-1	Fibroblasts
CTTTCAATCGCTCATC-1	Fibroblasts
CTTTCGGAGCACACAG-1	Endothelial cells
CTTTCGGAGCGACTGA-1	Fibroblasts
CTTTCGGAGGTCACCC-1	Epithelial cells
CTTTCGGGTACCACGC-1	Epithelial cells
CTTTCGGGTCCTTTGC-1	Monocytes
CTTTCGGTCAGGAAGC-1	Macrophages
CTTTCGGTCCGGCAAC-1	NK cells
CTTTCGGTCCGTGTAA-1	DC
CTTTCGGTCCTCACGT-1	NK cells
GAAACCTAGATCACCT-1	T cells
GAAACCTAGCACTTTG-1	T cells
GAAACCTCAAGGTTGG-1	T cells
GAAACCTCATCACAGT-1	T cells
GAAACCTGTCATTCCC-1	T cells
GAAACCTGTCGACTGC-1	Monocytes
GAAACCTTCAGAGTTC-1	Fibroblasts
GAAACCTTCAGCACCG-1	B cells
GAAACCTTCGCTCATC-1	Monocytes
GAAACCTTCTAATTCC-1	Epithelial cells
GAAATGAAGGTGGCTA-1	T cells
GAAATGACAATGAAAC-1	Epithelial cells
GAAATGACACCAAATC-1	Fibroblasts
GAAATGACAGCATGCC-1	T cells
GAAATGAGTAGTAAGT-1	T cells
GAAATGAGTCTGCATA-1	Fibroblasts
GAAATGAGTGGAATGC-1	Fibroblasts
GAAATGAGTGTATCCA-1	T cells
GAAATGAGTTCTTCAT-1	Fibroblasts
GAAATGAGTTGCTCAA-1	Monocytes
GAACACTAGTTCCATG-1	NK cells
GAACACTGTATGAAGT-1	Fibroblasts
GAACACTTCGACATAC-1	T cells
GAACACTTCGTGGCGT-1	T cells
GAACGTTGTTCGTACA-1	Fibroblasts
GAACGTTTCCATATGG-1	Monocytes
GAACGTTTCTAGCATG-1	Fibroblasts
GAACTGTCACTGCATA-1	T cells
GAACTGTGTGTAAATG-1	T cells
GAACTGTTCAAATAGG-1	T cells
GAAGAATGTAGTCCTA-1	Fibroblasts
GAAGAATGTGTCCAAT-1	Fibroblasts
GAAGAATGTTCCGGTG-1	Fibroblasts
GAAGAATTCACCCTGT-1	T cells
GAAGAATTCCACCTCA-1	T cells
GAAGCCCAGATTGTGA-1	Macrophages
GAAGCCCCAAAGACTA-1	Epithelial cells
GAAGCCCCACAGTGTT-1	Epithelial cells
GAAGCCCCAGTATACC-1	Epithelial cells
GAAGCCCCATACCGTA-1	Fibroblasts
GAAGCCCGTCGACTGC-1	Fibroblasts
GAAGCCCGTGACACAG-1	T cells
GAAGCCCTCTGTGCGG-1	Epithelial cells
GAAGCGAAGCAACAAT-1	T cells
GAAGCGAAGGAGCAAA-1	Fibroblasts
GAAGCGAAGGCCTAGA-1	Endothelial cells
GAAGCGAAGGCGTTGA-1	T cells
GAAGCGAAGTGGAATT-1	Fibroblasts
GAAGCGACAGGACGAT-1	Fibroblasts
GAAGCGAGTCCTTTGC-1	Macrophages
GAAGCGAGTCGTTTCC-1	T cells
GAAGGACAGATGTTGA-1	Fibroblasts
GAAGGACAGTCTAGCT-1	DC
GAAGGACCAATCTCTT-1	T cells
GAAGGACGTCAACGCC-1	T cells
GAAGGACGTGTACGCC-1	Fibroblasts
GAAGGACGTTTGACAC-1	Fibroblasts
GAAGGACTCCACGTAA-1	T cells
GAAGGACTCTGGACTA-1	T cells
GAAGGGTAGCAACTTC-1	Fibroblasts
GAAGGGTAGCTGACAG-1	Fibroblasts
GAAGGGTCACATTCTT-1	T cells
GAAGGGTGTAGCCAGA-1	Macrophages
GAAGGGTTCAAGAATG-1	Epithelial cells
GAAGGGTTCATGCCGG-1	Monocytes
GAAGGGTTCGCAGTCG-1	T cells
GAAGTAACAAGGTCAG-1	T cells
GAAGTAACACCCAATA-1	T cells
GAAGTAAGTCCAAATC-1	Fibroblasts
GAAGTAATCTGGACTA-1	Macrophages
GAATAGAAGCAGCGAT-1	Fibroblasts
GAATAGAAGCTTTGTG-1	Epithelial cells
GAATAGAAGTAGGATT-1	pDC
GAATAGACAACACAGG-1	NK cells
GAATAGAGTAAGTTGA-1	Epithelial cells
GAATAGAGTAGTCGGA-1	Endothelial cells
GAATAGAGTCCCTAAA-1	NK cells
GAATAGATCAAGTCTG-1	NK cells
GAATAGATCTCATGCC-1	Endothelial cells
GAATCACAGACAGTCG-1	Fibroblasts
GAATCACAGGTTCCGC-1	T cells
GAATCACAGTCTGCGC-1	Fibroblasts
GAATCACCAGCATGCC-1	Endothelial cells
GAATCACCATTCCTCG-1	T cells
GAATCACGTATGAGAT-1	T cells
GAATCACGTTTGCAGT-1	Fibroblasts
GAATCGTAGAGTCAGC-1	T cells
GAATCGTCATTGACAC-1	Fibroblasts
GAATCGTTCCATAAGC-1	T cells
GACACGCAGCTAATCC-1	Fibroblasts
GACACGCAGGGAGGGT-1	Fibroblasts
GACACGCGTGGTCCGT-1	Fibroblasts
GACACGCGTTCGGCCA-1	B cells
GACACGCTCATTACTC-1	T cells
GACACGCTCCTACTGC-1	Monocytes
GACAGCCGTCGGCCTA-1	Epithelial cells
GACAGCCTCCACGTCT-1	Fibroblasts
GACAGCCTCCGGACGT-1	T cells
GACATCACACATTCGA-1	Epithelial cells
GACATCACAGGGTCTC-1	Fibroblasts
GACATCAGTGCATGAG-1	Fibroblasts
GACATCATCCCGAGAC-1	T cells
GACATCATCCTCCACA-1	Macrophages
GACATCATCCTGTTGC-1	T cells
GACCAATAGGCCATAG-1	Epithelial cells
GACCAATCAACTTCTT-1	Epithelial cells
GACCAATCACGCTGTG-1	Monocytes
GACCAATGTACTCAAC-1	Fibroblasts
GACCAATTCAACCTTT-1	Fibroblasts
GACCAATTCCAACACA-1	Endothelial cells
GACCCAGCAATCACGT-1	T cells
GACCCAGCACGGGCTT-1	Epithelial cells
GACCCAGGTTCCGTTC-1	Monocytes
GACCCAGTCAAACGAA-1	Fibroblasts
GACCCTTAGACTCGAG-1	T cells
GACCCTTAGGATGCGT-1	T cells
GACCCTTAGTTGAAAC-1	Epithelial cells
GACCCTTCAGCCGTTG-1	Epithelial cells
GACCCTTCATGGGAAC-1	Monocytes
GACCCTTTCGGAATGG-1	T cells
GACCCTTTCGGACTGC-1	T cells
GACCCTTTCGTGGCTG-1	Endothelial cells
GACCGTGCACAGACGA-1	Monocytes
GACCGTGGTACCAATC-1	Fibroblasts
GACCGTGTCCTTACCG-1	T cells
GACCGTGTCGTAACTG-1	Epithelial cells
GACCTTCAGCATCCTA-1	Fibroblasts
GACCTTCAGGCCTTGC-1	Fibroblasts
GACCTTCAGTGCAGGT-1	T cells
GACCTTCGTTGTTGAC-1	Epithelial cells
GACCTTCGTTTGTTGG-1	T cells
GACCTTCTCACAACCA-1	Fibroblasts
GACCTTCTCAGGACAG-1	Fibroblasts
GACCTTCTCGCAATTG-1	B cells
GACGCTGAGATCACTC-1	Macrophages
GACGCTGAGATCCCAT-1	Macrophages
GACGCTGAGGGAGGCA-1	T cells
GACGCTGCAAGCAGGT-1	Fibroblasts
GACGCTGCAATGGCAG-1	Fibroblasts
GACGCTGGTCGCATCG-1	Epithelial cells
GACGCTGGTTCTCCCA-1	T cells
GACGCTGTCACATACG-1	Monocytes
GACGCTGTCCGTGGTG-1	T cells
GACGCTGTCCTTATGT-1	Monocytes
GACGCTGTCCTTCTGG-1	Fibroblasts
GACGTTAAGACGGTCA-1	Macrophages
GACGTTAAGCACACAG-1	T cells
GACGTTAAGGTACATA-1	Fibroblasts
GACGTTACAGGCACTC-1	Epithelial cells
GACGTTACATTGCCGG-1	Monocytes
GACGTTAGTGAGCGAT-1	Fibroblasts
GACGTTATCATCACAG-1	Fibroblasts
GACGTTATCCCGAGGT-1	Fibroblasts
GACTATGAGAGAGCCT-1	Epithelial cells
GACTATGAGCCATTCA-1	Fibroblasts
GACTATGAGGTCGTCC-1	Fibroblasts
GACTATGAGTATAGGT-1	pDC
GACTATGCACGGTGCT-1	pDC
GACTATGGTATTCCTT-1	Fibroblasts
GACTATGTCAAAGAAC-1	T cells
GACTATGTCTCGCCTA-1	Fibroblasts
GACTCAAAGCAGGCTA-1	T cells
GACTCAAAGTGATCGG-1	T cells
GACTCAACAGAGTCTT-1	Epithelial cells
GACTCAAGTTAGTTCG-1	pDC
GACTCTCAGCTGACTT-1	Mast cells
GACTCTCAGGAGACCT-1	Epithelial cells
GACTCTCAGGTCATAA-1	NK cells
GACTCTCAGTGCAGCA-1	Fibroblasts
GACTCTCAGTGGCGAT-1	Fibroblasts
GACTCTCAGTGTTGAA-1	Epithelial cells
GACTCTCCAACGAGGT-1	Endothelial cells
GACTCTCCAATTGCAC-1	T cells
GACTCTCGTGAGACGT-1	Epithelial cells
GACTGATCACACTTAG-1	Epithelial cells
GACTGATCATAATGAG-1	T cells
GACTGATCATGGTACT-1	T cells
GACTGATTCAAGCCCG-1	Epithelial cells
GACTGATTCGTCAAAC-1	pDC
GACTTCCAGCCGTCGT-1	Epithelial cells
GACTTCCCAACACAAA-1	Fibroblasts
GACTTCCCAATTGTGC-1	T cells
GACTTCCCAGTGGCTC-1	T cells
GACTTCCCATGGACAG-1	T cells
GACTTCCGTCGAGTTT-1	Macrophages
GACTTCCGTGGTCCGT-1	Fibroblasts
GACTTCCTCAATCTTC-1	Endothelial cells
GACTTCCTCTAGAGCT-1	Epithelial cells
GAGAAATAGCGACTTT-1	DC
GAGAAATAGGAAGAAC-1	T cells
GAGAAATCAACGAGGT-1	T cells
GAGAAATCACGGTCTG-1	Fibroblasts
GAGAAATGTCACCACG-1	Fibroblasts
GAGAAATGTTAACCTG-1	ILC
GAGAAATGTTCAAACC-1	T cells
GAGACCCAGACCCTTA-1	Fibroblasts
GAGACCCCAATCGTCA-1	Monocytes
GAGACCCGTTACACAC-1	Fibroblasts
GAGACCCTCAGAGCGA-1	Epithelial cells
GAGACTTAGGATGAGA-1	Epithelial cells
GAGACTTCAATTCTTC-1	DC
GAGACTTCAGACCAGA-1	Epithelial cells
GAGACTTCAGCACAAG-1	Fibroblasts
GAGACTTCATTAGGAA-1	T cells
GAGACTTGTATGAAGT-1	Plasma cells
GAGACTTGTCTACAAC-1	Macrophages
GAGACTTTCAGGAACG-1	T cells
GAGACTTTCGAGAAGC-1	Epithelial cells
GAGACTTTCGCATTGA-1	T cells
GAGACTTTCTTAGCTT-1	T cells
GAGAGGTAGCAATTCC-1	Epithelial cells
GAGAGGTAGTCACTCA-1	Fibroblasts
GAGAGGTCATTCTGTT-1	Epithelial cells
GAGAGGTGTCATGGCC-1	T cells
GAGAGGTGTTACCTGA-1	Fibroblasts
GAGAGGTTCAAAGACA-1	T cells
GAGATGGAGCCTGACC-1	T cells
GAGATGGAGGGACACT-1	Monocytes
GAGATGGCAGCTGCCA-1	Epithelial cells
GAGATGGCAGTGGGTA-1	T cells
GAGATGGCATGGAGAC-1	pDC
GAGATGGCATTGAAAG-1	Monocytes
GAGATGGTCGGCTCTT-1	Epithelial cells
GAGATGGTCTGGACTA-1	Macrophages
GAGCCTGAGACCAACG-1	T cells
GAGCCTGAGGGTAATT-1	Monocytes
GAGCCTGCAGAGTTCT-1	Fibroblasts
GAGCCTGCATCCGTTC-1	Epithelial cells
GAGCCTGTCGAACCTA-1	Fibroblasts
GAGCTGCCAATAACGA-1	T cells
GAGCTGCCACTGTGTA-1	T cells
GAGCTGCCATGACGAG-1	NK cells
GAGCTGCGTCTTGTCC-1	Epithelial cells
GAGCTGCGTTAACCTG-1	T cells
GAGCTGCTCGTAATGC-1	B cells
GAGGCAAAGAGGATCC-1	Fibroblasts
GAGGCAAAGCCGATCC-1	Monocytes
GAGGCAAAGCCGTCGT-1	T cells
GAGGCAAAGTTGAAAC-1	pDC
GAGGCAACAAATGCTC-1	T cells
GAGGCAACAGAGGAAA-1	Epithelial cells
GAGGCAAGTCAACACT-1	Fibroblasts
GAGGCAAGTCTGCAAT-1	T cells
GAGGCAAGTTGCTTGA-1	T cells
GAGGCAAGTTTCGTTT-1	DC
GAGGCAATCATTGGTG-1	Epithelial cells
GAGGCAATCGACCCAG-1	T cells
GAGGCCTAGAAACTGT-1	T cells
GAGGCCTAGGATTACA-1	Endothelial cells
GAGGCCTCAAGACTGG-1	Fibroblasts
GAGGCCTCACAAATCC-1	DC
GAGGCCTCACTAAACC-1	Fibroblasts
GAGGCCTGTACGCTAT-1	Fibroblasts
GAGGCCTGTGTAAACA-1	Fibroblasts
GAGGCCTTCAGCGGAA-1	Fibroblasts
GAGGCCTTCAGGTAAA-1	T cells
GAGGCCTTCATTCGTT-1	Monocytes
GAGGGATCAGGTGGAT-1	Mast cells
GAGGGATCAGTCAGTT-1	T cells
GAGGGATTCCACGTAA-1	T cells
GAGGGATTCTAACGCA-1	T cells
GAGGGTAAGATCGGTG-1	Fibroblasts
GAGGGTAAGCTCGAAG-1	Fibroblasts
GAGGGTAAGGTAATCA-1	T cells
GAGGGTAAGTAGCATA-1	Macrophages
GAGGGTACATGACAGG-1	Fibroblasts
GAGTCATAGTTACTCG-1	Epithelial cells
GAGTCATCAGCATGCC-1	T cells
GAGTCATCAGGTTCAT-1	Fibroblasts
GAGTCATGTCAAAGTA-1	Monocytes
GAGTCTAAGGCTTAGG-1	T cells
GAGTCTATCCCGATCT-1	T cells
GAGTCTATCCGAACGC-1	Fibroblasts
GAGTGAGAGCAGCCTC-1	T cells
GAGTGAGAGCGCCTTG-1	Fibroblasts
GAGTGAGAGGTTACAA-1	T cells
GAGTGAGAGTATGCAA-1	DC
GAGTGAGCAATCCTTT-1	T cells
GAGTGAGCAGCAGTAG-1	Epithelial cells
GAGTGAGGTTCGTAAC-1	Fibroblasts
GAGTGAGTCTGGCTGG-1	T cells
GAGTGTTAGAAACACT-1	Macrophages
GAGTGTTAGCGCTTCG-1	T cells
GAGTGTTAGGCGATAC-1	Epithelial cells
GAGTGTTAGGGATGTC-1	Endothelial cells
GAGTGTTGTAGACACG-1	Epithelial cells
GAGTGTTGTGGGCTCT-1	Monocytes
GAGTGTTGTTCGTAAC-1	T cells
GAGTGTTGTTGGTACT-1	T cells
GAGTTACAGACCATAA-1	Macrophages
GAGTTACCATCGAAGG-1	Monocytes
GAGTTACGTAGCGTAG-1	Fibroblasts
GAGTTACGTCAATCTG-1	Epithelial cells
GAGTTACGTTTCGGCG-1	T cells
GAGTTACTCAGAGTTC-1	T cells
GAGTTACTCCCAACTC-1	T cells
GAGTTGTAGACCCTTA-1	Macrophages
GAGTTGTCATTAAGCC-1	Fibroblasts
GAGTTTGAGAAGTATC-1	Macrophages
GAGTTTGAGACCAGAC-1	T cells
GAGTTTGAGAGGTTAT-1	Fibroblasts
GAGTTTGAGATACAGT-1	Macrophages
GAGTTTGAGGTTTACC-1	Epithelial cells
GAGTTTGAGTAATTGG-1	Fibroblasts
GAGTTTGCAACCACGC-1	T cells
GAGTTTGCAATTGAAG-1	Endothelial cells
GAGTTTGCAGTCCGTG-1	T cells
GAGTTTGGTGCATCTA-1	Macrophages
GAGTTTGGTTATAGAG-1	T cells
GAGTTTGGTTCCTACC-1	Monocytes
GAGTTTGGTTGCATAC-1	Epithelial cells
GAGTTTGTCGCTTGCT-1	Monocytes
GAGTTTGTCTGCTTTA-1	Fibroblasts
GATAGAAAGACTAGAT-1	T cells
GATAGAAAGGTAAGGA-1	Fibroblasts
GATAGAAAGTGCAAAT-1	T cells
GATAGAAAGTTGCTCA-1	pDC
GATAGAAGTCCCGTGA-1	Macrophages
GATAGAAGTCTCAAGT-1	Monocytes
GATAGAAGTTGGACTT-1	T cells
GATAGAATCCTCATAT-1	Endothelial cells
GATAGCTAGCCGGATA-1	Fibroblasts
GATAGCTAGGCTTAAA-1	Fibroblasts
GATAGCTAGTGATAGT-1	Fibroblasts
GATAGCTCACATTCGA-1	Fibroblasts
GATAGCTCAGGAGGAG-1	T cells
GATAGCTGTGCCTGCA-1	Epithelial cells
GATAGCTGTGGCGTAA-1	T cells
GATAGCTGTTGTCCCT-1	T cells
GATAGCTTCCTTTAGT-1	Epithelial cells
GATAGCTTCTATCGTT-1	Fibroblasts
GATCACAGTCTGTGGC-1	T cells
GATCACATCCACTGAA-1	B cells
GATCACATCCAGTGCG-1	T cells
GATCACATCGGCACTG-1	Fibroblasts
GATCAGTAGATGGTCG-1	NK cells
GATCAGTCAGCTACAT-1	T cells
GATCAGTGTAGGCAGT-1	T cells
GATCAGTTCATCACCC-1	Endothelial cells
GATCAGTTCTAGACAC-1	Fibroblasts
GATCAGTTCTAGGCCG-1	Endothelial cells
GATCAGTTCTTGTGCC-1	Epithelial cells
GATCATGAGCTGTCCG-1	Epithelial cells
GATCATGCAAGCTCTA-1	Macrophages
GATCATGCAGGAATCG-1	Monocytes
GATCATGGTTAATCGC-1	Epithelial cells
GATCATGTCAAGCCAT-1	T cells
GATCCCTAGCACCGTC-1	Fibroblasts
GATCCCTAGCATGTTC-1	Fibroblasts
GATCCCTAGCTGGCCT-1	Epithelial cells
GATCCCTAGTGGCAGT-1	T cells
GATCCCTCACCACATA-1	T cells
GATCCCTTCGTAGTCA-1	Epithelial cells
GATCGTAAGCATTTCG-1	Epithelial cells
GATCGTAGTGCCCTTT-1	Fibroblasts
GATCGTAGTTCATCTT-1	T cells
GATCGTAGTTCCGTTC-1	T cells
GATCGTATCGTGGGTC-1	T cells
GATCGTATCTCCGAGG-1	T cells
GATGACTAGTTGGCTT-1	Epithelial cells
GATGACTGTAGACGGT-1	T cells
GATGACTGTCGAGCAA-1	T cells
GATGACTTCATCGCCT-1	T cells
GATGACTTCATGGTAC-1	B cells
GATGACTTCCAAGCTA-1	Fibroblasts
GATGACTTCCATCTAT-1	Plasma cells
GATGACTTCCCGTAAA-1	T cells
GATGACTTCGGACGTC-1	Macrophages
GATGAGGAGGAGCTGT-1	ILC
GATGAGGCAACGACTT-1	Fibroblasts
GATGAGGCACCTGTCT-1	Fibroblasts
GATGAGGGTCTAACGT-1	Fibroblasts
GATGAGGTCATCGCTC-1	Epithelial cells
GATGAGGTCGAGAGCA-1	Epithelial cells
GATGATCAGCACTAAA-1	Epithelial cells
GATGATCCAAGCTACT-1	Fibroblasts
GATGATCCAGGCGATA-1	Fibroblasts
GATGATCGTAGTGATA-1	Epithelial cells
GATGATCTCCGACGGT-1	Monocytes
GATGCTAAGACCCTTA-1	Epithelial cells
GATGCTACACAGTCGC-1	Epithelial cells
GATGCTAGTGTTCGTA-1	Epithelial cells
GATGGAGAGGGACTGT-1	Epithelial cells
GATGGAGTCTTGCGCT-1	T cells
GATGTTGAGAGCCATG-1	T cells
GATGTTGAGATGTTCC-1	Fibroblasts
GATGTTGAGCTTCGTA-1	Epithelial cells
GATGTTGCAGATTCGT-1	Fibroblasts
GATGTTGTCAGTCAGT-1	Monocytes
GATGTTGTCCCGTAAA-1	B cells
GATGTTGTCGCCTATC-1	T cells
GATTCGAAGACATACA-1	T cells
GATTCGAAGCGATCGA-1	T cells
GATTCGAAGTAATACG-1	Fibroblasts
GATTCGAAGTCTCTGA-1	T cells
GATTCGACATGGAATA-1	Epithelial cells
GATTCGATCGTTCCCA-1	Epithelial cells
GATTCGATCTTGAACG-1	Epithelial cells
GATTCTTAGCTGACAG-1	pDC
GATTCTTCATGTCGTA-1	B cells
GATTCTTGTCTAGGTT-1	T cells
GATTCTTTCTGAGGCC-1	T cells
GATTCTTTCTGGGCCA-1	Endothelial cells
GATTGGTAGATGTTGA-1	Fibroblasts
GATTGGTAGCGCCGTT-1	T cells
GATTGGTAGGTGCTTT-1	T cells
GATTGGTCAATTCGTG-1	T cells
GATTGGTCATGCCGCA-1	Fibroblasts
GATTGGTGTTGCCAAT-1	T cells
GATTGGTTCCGTACGG-1	T cells
GATTGGTTCGACTCCT-1	T cells
GATTTCTAGAAACCCG-1	Fibroblasts
GATTTCTAGATCCTAC-1	Fibroblasts
GATTTCTAGCCGTAAG-1	Monocytes
GATTTCTAGTGATGGC-1	T cells
GATTTCTCACGCCACA-1	T cells
GATTTCTGTCGTACAT-1	Monocytes
GATTTCTGTCTTGAGT-1	Epithelial cells
GATTTCTGTTGCCGCA-1	Endothelial cells
GATTTCTGTTTCGCTC-1	T cells
GATTTCTTCACCTCTG-1	T cells
GATTTCTTCCCTCTAG-1	Fibroblasts
GCAACATAGGATTTCC-1	NK cells
GCAACATAGGGTGAAA-1	B cells
GCAACATCAAATCCCA-1	Fibroblasts
GCAACATCAATGGGTG-1	T cells
GCAACATCAGAGCTAG-1	Fibroblasts
GCAACATCAGGACATG-1	Fibroblasts
GCAACATGTACTGTTG-1	T cells
GCAACATGTCGTACAT-1	NK cells
GCAACATTCGGTAAGG-1	Fibroblasts
GCAACATTCTCATTGT-1	Monocytes
GCAACCGAGAATCGTA-1	Fibroblasts
GCAACCGAGAGATTCA-1	Fibroblasts
GCAACCGAGAGCCGTA-1	Epithelial cells
GCAACCGAGGTCATTC-1	DC
GCAACCGAGTACTGTC-1	T cells
GCAACCGCAATTCTTC-1	Epithelial cells
GCAACCGGTAACAGGC-1	Endothelial cells
GCAACCGTCACCGGGT-1	T cells
GCAACCGTCACTCACC-1	Epithelial cells
GCACATAAGTACAACA-1	Endothelial cells
GCACATACACGACAGA-1	T cells
GCACATACAGACTGCC-1	Macrophages
GCACATACAGCTGTGC-1	DC
GCACATACATTGTACG-1	T cells
GCACATAGTATCAGGG-1	Epithelial cells
GCACATAGTGTCTTGA-1	T cells
GCACGTGAGAATAACC-1	Fibroblasts
GCACGTGAGCCGTAAG-1	T cells
GCACGTGCATGGGTCC-1	T cells
GCACGTGGTATGCAAA-1	Fibroblasts
GCACTAACAGGACGAT-1	Endothelial cells
GCACTAAGTCCGAAAG-1	B cells
GCACTAATCGGCTGAC-1	T cells
GCACTAATCTAGGCCG-1	Fibroblasts
GCAGCCAAGTGTTGTC-1	pDC
GCAGCCACAAGCTCTA-1	T cells
GCAGCCACACCCTATC-1	Fibroblasts
GCAGCCAGTCACTCAA-1	Fibroblasts
GCAGCCAGTTCAAGTC-1	T cells
GCAGCCATCCCAGGAC-1	Fibroblasts
GCAGCTGAGCCTCGTG-1	pDC
GCAGCTGAGTGGTCAG-1	Macrophages
GCAGCTGCACAGAGCA-1	T cells
GCAGCTGCACCAGCTG-1	Epithelial cells
GCAGCTGCACCGTGCA-1	Monocytes
GCAGCTGGTGCCCAGT-1	T cells
GCAGCTGTCTTACCAT-1	Fibroblasts
GCAGGCTAGGTAAGGA-1	Fibroblasts
GCAGGCTCACGACAGA-1	Fibroblasts
GCAGGCTGTCGGCTAC-1	T cells
GCAGGCTGTGTCCATA-1	Epithelial cells
GCAGGCTGTTCAGCGC-1	Fibroblasts
GCAGGCTTCATAGCAC-1	Epithelial cells
GCAGGCTTCGCGATCG-1	Fibroblasts
GCAGGCTTCTGGGAGA-1	Epithelial cells
GCAGTTAAGGCTGTAG-1	DC
GCAGTTACACCATATG-1	Fibroblasts
GCAGTTAGTAACCCTA-1	Fibroblasts
GCAGTTAGTCTCGGAC-1	B cells
GCAGTTATCCACTTCG-1	T cells
GCAGTTATCCATAGAC-1	Monocytes
GCAGTTATCGCCAACG-1	Monocytes
GCAGTTATCTACGGTA-1	Fibroblasts
GCAGTTATCTATGTGG-1	Fibroblasts
GCATCGGAGGTTTACC-1	Epithelial cells
GCATCGGGTTAGTTCG-1	Fibroblasts
GCATCGGTCCGATCGG-1	T cells
GCATCGGTCTACACTT-1	Fibroblasts
GCATCTCCAAAGCGTG-1	B cells
GCATCTCCAATTTCTC-1	T cells
GCATCTCCACTACACA-1	DC
GCATCTCCAGGCGATA-1	Epithelial cells
GCATCTCCAGGTACGA-1	Macrophages
GCATCTCGTAAGGCTG-1	Epithelial cells
GCATCTCGTGATCATC-1	Epithelial cells
GCATCTCGTTGCCGCA-1	Monocytes
GCATCTCGTTGGACCC-1	T cells
GCATCTCTCACTCACC-1	DC
GCATCTCTCGGTAACT-1	Epithelial cells
GCATCTCTCTACAGGT-1	T cells
GCATGATAGATTGATG-1	pDC
GCATGATAGTGAATAC-1	NK cells
GCATGATCAGTCGGTC-1	T cells
GCATGATCATAATCCG-1	B cells
GCATGATGTAAGCTCT-1	T cells
GCATGATGTAATGATG-1	Monocytes
GCATGATGTGATACTC-1	T cells
GCATTAGCAAATGAGT-1	NK cells
GCATTAGCAAATGGAT-1	Epithelial cells
GCATTAGCATTCTTCA-1	Plasma cells
GCATTAGGTACGCTTA-1	Fibroblasts
GCATTAGTCACGATCA-1	Epithelial cells
GCATTAGTCCGACATA-1	Monocytes
GCATTAGTCGAACTCA-1	Fibroblasts
GCCAACGAGCGCTTCG-1	T cells
GCCAACGCAAGCTACT-1	T cells
GCCAACGCAGCGTTGC-1	T cells
GCCAACGCAGGCATTT-1	Fibroblasts
GCCAACGTCTCGCTCA-1	Macrophages
GCCAGCAAGACGAGCT-1	Fibroblasts
GCCAGCAAGCGGCTCT-1	Macrophages
GCCAGCAAGGGTTAGC-1	Epithelial cells
GCCAGCAAGGTCTTTG-1	B cells
GCCAGCACATACAGGG-1	Epithelial cells
GCCAGCATCCATAGGT-1	Fibroblasts
GCCAGCATCGAGTACT-1	Fibroblasts
GCCAGGTAGGAGCAAA-1	T cells
GCCAGGTCATGGGTTT-1	T cells
GCCAGGTGTCATCGCG-1	Fibroblasts
GCCAGGTGTCGTCTCT-1	T cells
GCCAGGTGTGCAATAA-1	Fibroblasts
GCCAGGTGTGGCTGCT-1	Epithelial cells
GCCAGGTGTTGCATAC-1	T cells
GCCAGGTGTTGCCAAT-1	Epithelial cells
GCCAGGTTCACCTTAT-1	Fibroblasts
GCCAGGTTCCTTATAC-1	Epithelial cells
GCCAGGTTCTCATGCC-1	Fibroblasts
GCCAGTGCAATAAGGT-1	Epithelial cells
GCCAGTGCACACTTAG-1	Epithelial cells
GCCAGTGCACTACGGC-1	Fibroblasts
GCCAGTGGTACACGTT-1	T cells
GCCAGTGTCAGGAACG-1	Epithelial cells
GCCAGTGTCGAGAGAC-1	T cells
GCCATGGAGAAACTCA-1	T cells
GCCATGGAGCTGACTT-1	T cells
GCCATGGCACGTCGTG-1	Fibroblasts
GCCATGGCACTACAGT-1	Epithelial cells
GCCATGGCAGGTTACT-1	Endothelial cells
GCCATGGGTTATGTGC-1	T cells
GCCATGGTCCAGTGTA-1	Fibroblasts
GCCATTCAGACCATGG-1	T cells
GCCATTCAGCGAATGC-1	ILC
GCCATTCAGGATATAC-1	Monocytes
GCCATTCCAAGCGCAA-1	Fibroblasts
GCCATTCCACACTGGC-1	T cells
GCCATTCGTACCGTGC-1	Endothelial cells
GCCATTCGTAGTATAG-1	ILC
GCCATTCTCATGCAGT-1	Fibroblasts
GCCATTCTCTGGTTGA-1	Fibroblasts
GCCATTCTCTTAGCAG-1	T cells
GCCATTCTCTTCACAT-1	Endothelial cells
GCCATTCTCTTCCGTG-1	Fibroblasts
GCCATTCTCTTCGCTG-1	Epithelial cells
GCCCAGAAGAGATGCC-1	T cells
GCCCAGACAAACTCGT-1	T cells
GCCCAGACAAGTAGTA-1	Monocytes
GCCCAGACACACCTTC-1	Fibroblasts
GCCCAGACAGTCGGTC-1	Epithelial cells
GCCCAGAGTACTCAAC-1	pDC
GCCCAGAGTCACTCTC-1	NK cells
GCCCAGATCACACCGG-1	Fibroblasts
GCCCAGATCATTACGG-1	T cells
GCCCAGATCCTAAACG-1	Endothelial cells
GCCCGAAAGAAATGGG-1	Monocytes
GCCCGAAAGAGAGCCT-1	Monocytes
GCCCGAACAATAGGGC-1	Fibroblasts
GCCCGAACACGCGGTT-1	T cells
GCCCGAACAGCTGCCA-1	Fibroblasts
GCCCGAAGTGTGAATA-1	T cells
GCCCGAAGTTACAGCT-1	Fibroblasts
GCCGATGCAGCAGTGA-1	T cells
GCCGATGCATCCCACT-1	Epithelial cells
GCCGATGGTCAGACTT-1	Macrophages
GCCGATGTCAGCGCAC-1	T cells
GCCGTGAAGCCGCTTG-1	DC
GCCGTGACAAATCAGA-1	Endothelial cells
GCCGTGACAGAATGTA-1	Monocytes
GCCGTGAGTATTGACC-1	Fibroblasts
GCCGTGAGTGTCCACG-1	T cells
GCCGTGATCGTGGGAA-1	Epithelial cells
GCCGTGATCTCTTAAC-1	B cells
GCCTGTTAGGTCATCT-1	T cells
GCCTGTTCAGTTTGGT-1	Macrophages
GCCTGTTGTACCATAC-1	Fibroblasts
GCCTGTTGTACCTATG-1	T cells
GCCTGTTGTACGGCAA-1	Fibroblasts
GCCTGTTTCTAGTGAC-1	Fibroblasts
GCGAGAAAGACATGCG-1	Fibroblasts
GCGAGAAAGCACGGAT-1	Epithelial cells
GCGAGAAAGCGATCGA-1	Epithelial cells
GCGAGAACAGCTACAT-1	Epithelial cells
GCGAGAAGTACTGTTG-1	Fibroblasts
GCGAGAATCGCAATGT-1	T cells
GCGATCGAGATGGTCG-1	Epithelial cells
GCGATCGCAACGACAG-1	Fibroblasts
GCGATCGCACCTCGTT-1	Epithelial cells
GCGATCGGTCCCGTGA-1	T cells
GCGATCGGTGAGATTA-1	ILC
GCGGAAAAGCGTGTTT-1	T cells
GCGGAAAAGCTACTGT-1	Monocytes
GCGGAAAAGCTTGTGT-1	Macrophages
GCGGAAAAGTGGTTCT-1	Fibroblasts
GCGGAAACAGACCAGA-1	T cells
GCGGAAAGTCAAAGAT-1	T cells
GCGGAAAGTCAGCTTA-1	T cells
GCGGAAAGTGACTATC-1	Macrophages
GCGGAAAGTGTTCCTC-1	Fibroblasts
GCGGAAAGTTCAGTAC-1	Fibroblasts
GCGGAAAGTTGTAAAG-1	T cells
GCGGAAATCCGCTTAC-1	Epithelial cells
GCGGAAATCTACACTT-1	Endothelial cells
GCGGATCCAATCGAAA-1	T cells
GCGGATCTCCTTATGT-1	Fibroblasts
GCGTGCAAGAAATGGG-1	NK cells
GCGTGCAAGGCGATAC-1	B cells
GCGTGCACAAGACTGG-1	Monocytes
GCGTGCAGTGGACTAG-1	B cells
GCGTGCATCACAAGAA-1	Monocytes
GCGTGCATCGTAGGGA-1	Epithelial cells
GCGTGCATCTACGCGG-1	Macrophages
GCGTTTCAGCATGTTC-1	Fibroblasts
GCGTTTCAGGAGTCTG-1	Macrophages
GCGTTTCAGGGCAGAG-1	DC
GCGTTTCGTTCCTTGC-1	Macrophages
GCGTTTCTCAAGTAAG-1	Epithelial cells
GCGTTTCTCAGACCCG-1	Monocytes
GCTACAAAGTGATTCC-1	Endothelial cells
GCTACAAAGTTAGTGA-1	T cells
GCTACAAAGTTGAAAC-1	Fibroblasts
GCTACAAAGTTGTAGA-1	Fibroblasts
GCTACAACAAGTCCAT-1	Fibroblasts
GCTACAACATACCAGT-1	DC
GCTACAAGTACGACAG-1	DC
GCTACAATCAGCATTG-1	B cells
GCTACAATCCGCTAGG-1	Monocytes
GCTACAATCCGTATAG-1	B cells
GCTACCTAGCCGTCGT-1	Fibroblasts
GCTACCTAGTCGAAAT-1	T cells
GCTACCTGTACCTGTA-1	T cells
GCTACCTGTACGGTTT-1	T cells
GCTACCTGTAGCGCCT-1	Epithelial cells
GCTACCTGTGCAATAA-1	T cells
GCTACCTGTTCGGCCA-1	T cells
GCTACCTGTTCGGCTG-1	Epithelial cells
GCTACCTTCAGGCGAA-1	Monocytes
GCTACCTTCCTTGACC-1	Epithelial cells
GCTCAAAGTAGTGCGA-1	T cells
GCTCAAAGTCACTGAT-1	Monocytes
GCTCAAAGTCTTGCGG-1	pDC
GCTCAAATCAGGGTAG-1	Fibroblasts
GCTCAAATCATCTACT-1	T cells
GCTCAAATCTCTATGT-1	Fibroblasts
GCTGAATAGTTCCTGA-1	T cells
GCTGAATCAACCTATG-1	T cells
GCTGAATCACCATATG-1	Fibroblasts
GCTGAATCACCTATCC-1	T cells
GCTGAATCATTCCTCG-1	Macrophages
GCTGCAGAGTCAGCCC-1	Epithelial cells
GCTGCAGAGTTAGAAC-1	pDC
GCTGCAGCAAACTGCT-1	Endothelial cells
GCTGCAGGTGTACATC-1	Fibroblasts
GCTGCAGTCAAGGACG-1	Fibroblasts
GCTGCAGTCGAATGCT-1	Macrophages
GCTGGGTAGACAGCGT-1	Endothelial cells
GCTGGGTAGATAACAC-1	Fibroblasts
GCTGGGTAGCTAGATA-1	Fibroblasts
GCTGGGTAGTCCGTCG-1	T cells
GCTGGGTCAACAGAGC-1	Epithelial cells
GCTGGGTCACCCTGAG-1	Macrophages
GCTGGGTCATGTGCCG-1	pDC
GCTGGGTGTCCGGTGT-1	Endothelial cells
GCTGGGTGTTTGGGTT-1	T cells
GCTGGGTTCCCTGTTG-1	T cells
GCTTCACGTAACGTTC-1	Monocytes
GCTTCACGTATGTCTG-1	DC
GCTTCACGTCCAGAAG-1	Fibroblasts
GCTTCACGTGTACGCC-1	T cells
GCTTCACTCATGTCTT-1	Fibroblasts
GCTTCACTCGCCGAAC-1	T cells
GCTTCACTCGTGGGAA-1	Epithelial cells
GCTTCACTCTCCGTGT-1	Fibroblasts
GCTTCACTCTCTCCGA-1	T cells
GCTTCACTCTGATGGT-1	T cells
GCTTGGGAGAGGTCGT-1	Monocytes
GCTTGGGAGGAGAGGC-1	Fibroblasts
GCTTGGGAGGTAGCCA-1	Epithelial cells
GCTTGGGCAAGGGTCA-1	T cells
GCTTGGGCACAACGCC-1	Epithelial cells
GCTTGGGCAGAGCCCT-1	Endothelial cells
GCTTGGGCATGACTTG-1	NK cells
GCTTGGGGTGGAACAC-1	Fibroblasts
GCTTGGGTCTAAGCCA-1	Fibroblasts
GCTTTCGAGAATCGCG-1	Epithelial cells
GCTTTCGCACAGAGAC-1	DC
GCTTTCGTCACAACCA-1	T cells
GCTTTCGTCGACGCTG-1	Epithelial cells
GCTTTCGTCGTCCTTG-1	Mast cells
GGAACCCAGTCGCTAT-1	NK cells
GGAACCCCAAGCTACT-1	T cells
GGAACCCTCAGACTGT-1	Fibroblasts
GGAACCCTCCATTCAT-1	Fibroblasts
GGAAGTGAGCATGATA-1	Monocytes
GGAAGTGCACGAGGTA-1	Epithelial cells
GGAAGTGCAGGACATG-1	Fibroblasts
GGAAGTGGTCATAAAG-1	Fibroblasts
GGAAGTGGTCCGTTTC-1	Endothelial cells
GGAAGTGTCCACTGAA-1	Fibroblasts
GGAATCTGTCCTATAG-1	Plasma cells
GGAATCTGTGGGATTG-1	T cells
GGAATGGAGATGAATC-1	Epithelial cells
GGAATGGCAATTGTGC-1	Fibroblasts
GGAATGGCACGTAACT-1	Fibroblasts
GGAATGGGTTACAGCT-1	T cells
GGAATGGTCATCGTAG-1	T cells
GGAATGGTCGACATAC-1	Monocytes
GGACGTCAGCGCTGAA-1	Epithelial cells
GGACGTCAGCTAAGTA-1	T cells
GGACGTCAGGCGCTCT-1	Monocytes
GGACGTCAGTCGGGAT-1	Macrophages
GGACGTCGTACTAACC-1	T cells
GGAGAACAGTGCACAG-1	T cells
GGAGAACCACAGCTTA-1	Epithelial cells
GGAGAACCACTCCGGA-1	Epithelial cells
GGAGAACCATAGTCAC-1	T cells
GGAGAACCATTCGGGC-1	Monocytes
GGAGAACGTACTCCCT-1	Monocytes
GGAGAACTCCTCATAT-1	T cells
GGAGAACTCGTCCATC-1	Monocytes
GGAGAACTCGTGTGAT-1	DC
GGAGATGAGTCTGGTT-1	Epithelial cells
GGAGATGAGTCTTCCC-1	Epithelial cells
GGAGATGCAAGAGCTG-1	Fibroblasts
GGAGATGCAGGTTCAT-1	Monocytes
GGAGATGGTTCGAGCC-1	Plasma cells
GGAGCAATCCATGCAA-1	Fibroblasts
GGAGGATAGGCATTTC-1	Monocytes
GGAGGATAGGCTATCT-1	Fibroblasts
GGAGGATAGGTACATA-1	Endothelial cells
GGAGGATAGTCTACCA-1	Endothelial cells
GGAGGATCAGCTTTGA-1	Fibroblasts
GGAGGATGTCAGTCCG-1	T cells
GGAGGATGTCATCCGG-1	Endothelial cells
GGAGGATGTCGTCATA-1	Fibroblasts
GGAGGATGTTCATCGA-1	Fibroblasts
GGAGGATTCCCATTTA-1	Fibroblasts
GGAGGATTCCCTCAAC-1	Epithelial cells
GGAGGTACATGGCGCT-1	NK cells
GGAGGTAGTATGAAAC-1	Mast cells
GGAGGTAGTTTCACTT-1	Fibroblasts
GGAGGTATCGAGAGCA-1	T cells
GGAGGTATCTTCGGAA-1	T cells
GGATCTAAGCTTTCCC-1	Fibroblasts
GGATCTAAGTAGCAAT-1	Monocytes
GGATCTAAGTCCCTAA-1	T cells
GGATCTACACAGCCTG-1	Epithelial cells
GGATCTACAGAGTGTG-1	Epithelial cells
GGATCTACATCACAGT-1	NK cells
GGATCTAGTGTGTGGA-1	pDC
GGATCTATCAGTGTGT-1	Epithelial cells
GGATCTATCCGAGTGC-1	Fibroblasts
GGATGTTAGCTTACGT-1	Fibroblasts
GGATGTTAGTGAGCCA-1	Fibroblasts
GGATGTTGTCACCCTT-1	Epithelial cells
GGATGTTTCGACCCAG-1	Fibroblasts
GGCACGTAGGGAACAA-1	T cells
GGCACGTCACAACCGC-1	T cells
GGCACGTGTAACATGA-1	T cells
GGCACGTTCAAGGACG-1	Fibroblasts
GGCACGTTCGTTCTAT-1	Epithelial cells
GGCAGTCAGACGCTCC-1	DC
GGCAGTCGTCCACTCT-1	pDC
GGCAGTCGTTGCGAAG-1	Fibroblasts
GGCGTCAAGTCTAGAA-1	Fibroblasts
GGCGTCACAACGATTC-1	DC
GGCGTCACAAGGAGTC-1	Fibroblasts
GGCGTCACATCATCCC-1	Epithelial cells
GGCGTCACATCCCGTT-1	T cells
GGCGTCAGTACCCAGC-1	Epithelial cells
GGCTGTGAGATAGTCA-1	Macrophages
GGCTGTGGTCACTTCC-1	T cells
GGCTGTGGTCTGCATA-1	Epithelial cells
GGCTGTGGTTATGTGC-1	Monocytes
GGCTGTGTCCCTGTTG-1	Fibroblasts
GGCTGTGTCTATTCGT-1	Fibroblasts
GGCTTGGAGAGCCTGA-1	Fibroblasts
GGCTTGGAGATGACCG-1	Monocytes
GGCTTGGCAAGTCATC-1	T cells
GGCTTGGGTAAGTCAA-1	Fibroblasts
GGCTTGGGTCTTCGAA-1	Fibroblasts
GGCTTGGTCGAACCTA-1	T cells
GGCTTTCAGACGCATG-1	Fibroblasts
GGCTTTCAGCTTTCTT-1	Epithelial cells
GGCTTTCCAACGCCCA-1	Fibroblasts
GGCTTTCCAAGCTGCC-1	Fibroblasts
GGCTTTCCAAGGACAC-1	Fibroblasts
GGCTTTCCAATACAGA-1	Fibroblasts
GGCTTTCCATGGAGAC-1	Endothelial cells
GGCTTTCGTACCTAAC-1	Epithelial cells
GGCTTTCGTCAAGGCA-1	Fibroblasts
GGCTTTCGTCACATTG-1	Epithelial cells
GGCTTTCTCCACCTCA-1	Monocytes
GGCTTTCTCCCGTAAA-1	B cells
GGCTTTCTCCGTGCGA-1	Fibroblasts
GGCTTTCTCGATACAC-1	Monocytes
GGCTTTCTCGCAATTG-1	T cells
GGCTTTCTCGTCTAAG-1	Fibroblasts
GGGAAGTAGGACAGCT-1	Epithelial cells
GGGAAGTAGTCGAATA-1	ILC
GGGAAGTGTAGCTGTT-1	T cells
GGGAAGTGTCAACATC-1	Fibroblasts
GGGACAACACGCTGAC-1	Fibroblasts
GGGACAACAGCGACAA-1	Epithelial cells
GGGACAAGTCTTAGTG-1	Endothelial cells
GGGACAATCAGTGCGC-1	Fibroblasts
GGGACCTAGAGTGTTA-1	T cells
GGGACCTAGTACAGAT-1	Monocytes
GGGACCTCAGCACACC-1	Fibroblasts
GGGACCTGTACCTATG-1	Macrophages
GGGACCTGTAGATGTA-1	Fibroblasts
GGGACCTGTCACCCTT-1	Epithelial cells
GGGACCTGTGACTCGC-1	Epithelial cells
GGGACCTTCCGTGTCT-1	Epithelial cells
GGGACCTTCTAACGGT-1	Epithelial cells
GGGACCTTCTTCGGAA-1	Fibroblasts
GGGACTCAGCTGAAGC-1	Macrophages
GGGACTCAGGTGCGAT-1	Fibroblasts
GGGACTCCACGATAGG-1	T cells
GGGACTCCATCGATGT-1	T cells
GGGACTCGTACCACGC-1	Fibroblasts
GGGACTCTCAGAGTTC-1	T cells
GGGACTCTCAGTGTGT-1	Monocytes
GGGAGATCAAGTTTGC-1	T cells
GGGAGATCAGCTGGTC-1	Fibroblasts
GGGAGATCAGTCTACA-1	Macrophages
GGGAGATCATCCGTGG-1	Fibroblasts
GGGAGATGTTAAAGTG-1	T cells
GGGAGATGTTCAATCG-1	pDC
GGGAGATTCCGCACGA-1	pDC
GGGAGATTCGCTAGCG-1	Monocytes
GGGAGTAAGACTTGTC-1	Fibroblasts
GGGAGTAAGGGCATGT-1	T cells
GGGAGTAGTTGGAGAC-1	Macrophages
GGGAGTATCAAGCCCG-1	T cells
GGGAGTATCCCTAGGG-1	Fibroblasts
GGGAGTATCTATGCCC-1	Fibroblasts
GGGAGTATCTTGAGCA-1	T cells
GGGATCCAGTTGAAAC-1	Epithelial cells
GGGATCCCAACACGAG-1	T cells
GGGATCCCAGGAAGTC-1	Fibroblasts
GGGATCCGTCTAGATC-1	T cells
GGGATCCTCCGGTAGC-1	T cells
GGGATCCTCGTCTAAG-1	Epithelial cells
GGGATCCTCTATCGTT-1	Fibroblasts
GGGATCCTCTTAGCTT-1	T cells
GGGATGACACAGACGA-1	T cells
GGGATGACACGTACAT-1	Monocytes
GGGATGACACTCCGGA-1	Fibroblasts
GGGATGACAGTAACCT-1	Fibroblasts
GGGATGATCACCGACG-1	B cells
GGGCCATAGCCTTGAT-1	NK cells
GGGCCATGTAATGCGG-1	Endothelial cells
GGGCCATGTTTGATCG-1	T cells
GGGCCATGTTTGTTCT-1	Fibroblasts
GGGCCATTCACAAGAA-1	DC
GGGCCATTCGGAACTT-1	Epithelial cells
GGGCGTTAGGAATGTT-1	T cells
GGGCGTTCAGTCTGGC-1	NK cells
GGGCGTTCATAAGCGG-1	Fibroblasts
GGGCGTTGTACAAAGT-1	Epithelial cells
GGGCGTTGTATCAGCT-1	T cells
GGGCGTTGTCAGATTC-1	Monocytes
GGGCGTTGTTTCGTGA-1	Plasma cells
GGGCGTTTCCATGCAA-1	T cells
GGGCGTTTCCCATAAG-1	Fibroblasts
GGGCGTTTCCCATAGA-1	Endothelial cells
GGGCGTTTCCCTCTAG-1	T cells
GGGCGTTTCGAATCCA-1	T cells
GGGCTACAGTAGCAAT-1	Fibroblasts
GGGCTACAGTAGTCTC-1	Epithelial cells
GGGCTACCAGAGTTGG-1	Fibroblasts
GGGCTACCAGTTCTAG-1	Epithelial cells
GGGCTACGTGAATATG-1	T cells
GGGCTACGTGCCTATA-1	Monocytes
GGGCTACTCATTTCGT-1	T cells
GGGCTACTCGGCATTA-1	Plasma cells
GGGCTCAAGCTGTTAC-1	Endothelial cells
GGGCTCACAGCATGCC-1	T cells
GGGCTCAGTACAGTAA-1	Macrophages
GGGCTCAGTGCGGATA-1	B cells
GGGCTCAGTGGGTATG-1	Endothelial cells
GGGCTCAGTTACGGAG-1	Macrophages
GGGTAGAAGCTGTGCC-1	T cells
GGGTAGAAGGTCGTGA-1	Fibroblasts
GGGTAGACAACACGAG-1	pDC
GGGTAGACATCTCAAG-1	Fibroblasts
GGGTAGATCCACGGGT-1	Epithelial cells
GGGTAGATCCCTCATG-1	T cells
GGGTAGATCTATTCGT-1	T cells
GGGTATTAGGCTTAGG-1	Fibroblasts
GGGTATTAGTCTTCCC-1	Macrophages
GGGTATTCAAAGGCTG-1	T cells
GGGTATTCAACAGTGG-1	Mast cells
GGGTATTCACGACAAG-1	T cells
GGGTATTCATAAGATG-1	T cells
GGGTATTGTCACTTCC-1	Fibroblasts
GGGTATTGTCATGACT-1	Epithelial cells
GGGTATTGTGCGCTCA-1	T cells
GGGTATTTCAAGCCCG-1	Fibroblasts
GGGTATTTCCTTCACG-1	Monocytes
GGGTCACAGCAAACAT-1	B cells
GGGTCACAGCACACAG-1	T cells
GGGTCACCATTGACAC-1	Fibroblasts
GGGTCACGTAGATTGA-1	T cells
GGGTCACGTCAGTCTA-1	Monocytes
GGGTCTGAGAAGAGCA-1	T cells
GGGTCTGCAGTGGTGA-1	Monocytes
GGGTCTGGTACTAACC-1	T cells
GGGTCTGGTAGCTTTG-1	pDC
GGGTCTGGTGTGGACA-1	Fibroblasts
GGGTCTGGTTGCGAAG-1	Endothelial cells
GGGTGAACAACCCGCA-1	Monocytes
GGGTGAAGTCAACATC-1	Endothelial cells
GGGTGAATCATTACCT-1	B cells
GGGTGAATCTGGTCAA-1	T cells
GGGTGAATCTGTCAGA-1	Plasma cells
GGGTGTCAGGAAGTGA-1	T cells
GGGTGTCCAGTTAAAG-1	Epithelial cells
GGGTGTCCATGACCCG-1	Fibroblasts
GGGTGTCGTCACCTTC-1	Macrophages
GGGTGTCGTGCATTAC-1	Endothelial cells
GGGTGTCTCCACAGGC-1	T cells
GGGTGTCTCCGACATA-1	Epithelial cells
GGGTGTCTCTATTCGT-1	Epithelial cells
GGGTGTCTCTTTCTAG-1	T cells
GGGTTATAGAGATCGC-1	Fibroblasts
GGGTTATAGAGGATCC-1	T cells
GGGTTATAGCACTAAA-1	Endothelial cells
GGGTTATAGTACAGCG-1	Fibroblasts
GGGTTATCAACAGCCC-1	NK cells
GGGTTATCAAGTCCAT-1	Macrophages
GGGTTATGTACAATAG-1	Epithelial cells
GGGTTATGTCGCAGTC-1	T cells
GGGTTATGTTTCACAG-1	T cells
GGGTTATTCAAGTTGC-1	Fibroblasts
GGGTTATTCATTTACC-1	Epithelial cells
GGGTTTAAGAGTGTGC-1	Epithelial cells
GGGTTTACACGCTTAA-1	T cells
GGGTTTACAGCTAACT-1	Fibroblasts
GGGTTTACAGCTATTG-1	Plasma cells
GGGTTTAGTATGGTAA-1	Epithelial cells
GGGTTTAGTCCGGATC-1	Endothelial cells
GGGTTTAGTTCTCACC-1	NK cells
GGGTTTATCAAACCCA-1	T cells
GGTAACTAGAAGCTGC-1	T cells
GGTAACTAGGCTCTCG-1	Fibroblasts
GGTAACTAGTAACCGG-1	pDC
GGTAACTCAGTTGTTG-1	pDC
GGTAACTCATCTCGTC-1	T cells
GGTAACTGTCAGTCGC-1	Fibroblasts
GGTAACTTCACAAGAA-1	Fibroblasts
GGTAACTTCACTCGAA-1	Fibroblasts
GGTAACTTCCCGTGAG-1	T cells
GGTAATCCAAGCGAAC-1	T cells
GGTAATCCAAGGAGTC-1	Endothelial cells
GGTAATCTCACATCAG-1	Macrophages
GGTAATCTCAGCATTG-1	Fibroblasts
GGTAATCTCGTCGATA-1	T cells
GGTAGAGAGCGAAACC-1	T cells
GGTAGAGCAGACAATA-1	Epithelial cells
GGTAGAGCATCTAACG-1	pDC
GGTAGAGCATTCACCC-1	Epithelial cells
GGTAGAGGTATCCTTT-1	Fibroblasts
GGTAGAGGTGACCTGC-1	T cells
GGTAGAGTCTAGTGTG-1	Fibroblasts
GGTAGAGTCTGAGATC-1	Fibroblasts
GGTCACGCAACACTAC-1	Fibroblasts
GGTCACGCATTAAAGG-1	Fibroblasts
GGTCTGGAGCCTGACC-1	T cells
GGTCTGGGTCTCACGG-1	ILC
GGTCTGGGTTCTCCTG-1	Epithelial cells
GGTCTGGGTTGAGAGC-1	Fibroblasts
GGTCTGGTCATACGGT-1	Epithelial cells
GGTGAAGAGCGATGAC-1	T cells
GGTGAAGAGTGGTTAA-1	Fibroblasts
GGTGAAGCACACCTTC-1	Monocytes
GGTGAAGCACTGTCGG-1	Epithelial cells
GGTGAAGCAGTATACC-1	T cells
GGTGAAGTCGACCCAG-1	pDC
GGTGAAGTCGCATGAT-1	T cells
GGTGAAGTCTGACAGT-1	Monocytes
GGTGAAGTCTTCCAGC-1	T cells
GGTGATTCAGCGAACA-1	B cells
GGTGATTCAGGTCAAG-1	Endothelial cells
GGTGATTGTGAGGCAT-1	Monocytes
GGTGATTGTGGTCCGT-1	T cells
GGTGGCTGTACGCTTA-1	Monocytes
GGTGGCTGTATTCTCT-1	Fibroblasts
GGTGGCTGTCTGTGAT-1	Fibroblasts
GGTGGCTGTGATGAAT-1	Monocytes
GGTGTCGAGGTAATCA-1	Epithelial cells
GGTGTCGAGTGGCGAT-1	Epithelial cells
GGTGTCGGTAACTAAG-1	T cells
GGTGTCGGTATTCCTT-1	Macrophages
GGTGTCGGTCCTTAAG-1	Fibroblasts
GGTGTCGGTGATGTAA-1	Macrophages
GGTGTTAAGTCTGCAT-1	Monocytes
GGTGTTACACGGATCC-1	Epithelial cells
GGTGTTAGTAGACAGC-1	T cells
GGTGTTAGTGCTCTCT-1	Fibroblasts
GGTGTTAGTTCAGCGC-1	DC
GGTGTTATCTAGCCTC-1	Fibroblasts
GGTGTTATCTCGGTCT-1	T cells
GGTTAACAGCATTTGC-1	T cells
GGTTAACCAAGGTCGA-1	T cells
GGTTAACCATGGTGGA-1	T cells
GGTTAACGTACTGAGG-1	Fibroblasts
GGTTAACGTGACGTCC-1	Monocytes
GGTTAACGTGATTCTG-1	Macrophages
GGTTAACGTTATCTGG-1	T cells
GGTTAACGTTCCAAAC-1	Fibroblasts
GGTTAACTCGACATCA-1	Monocytes
GGTTAACTCGACGCTG-1	T cells
GGTTCTCAGAGGTCGT-1	Epithelial cells
GGTTCTCAGTAGTGCG-1	Fibroblasts
GGTTCTCCAACGCCCA-1	B cells
GGTTCTCCATCGTGCG-1	T cells
GGTTCTCGTACGATGG-1	T cells
GGTTCTCGTGTCTAAC-1	Endothelial cells
GGTTCTCTCACTGAAC-1	Endothelial cells
GGTTCTCTCTGTCCGT-1	T cells
GGTTGTAAGGCTGAAC-1	Endothelial cells
GGTTGTAAGTAGAATC-1	T cells
GGTTGTACAACACACT-1	Mast cells
GGTTGTACATAGACTC-1	Fibroblasts
GGTTGTATCCGACGGT-1	Monocytes
GGTTGTATCGACGCGT-1	Monocytes
GGTTGTATCTAGTCAG-1	Epithelial cells
GGTTGTATCTGCTTAT-1	Fibroblasts
GTAACACAGACCATTC-1	Fibroblasts
GTAACACAGGCTCTAT-1	Fibroblasts
GTAACACAGGGACAGG-1	Endothelial cells
GTAACACCACGCAGTC-1	Fibroblasts
GTAACACCATCGCCTT-1	T cells
GTAACACCATGAGAAT-1	T cells
GTAACACTCAGCAGAG-1	Fibroblasts
GTAACACTCCCTTGTG-1	Fibroblasts
GTAACACTCCTTGAAG-1	Fibroblasts
GTAACACTCGCTTAAG-1	T cells
GTAACCACAATGTCTG-1	Endothelial cells
GTAACCACAATTCGTG-1	T cells
GTAACCACAGCGGTTC-1	Fibroblasts
GTAACCACATGGGTCC-1	Epithelial cells
GTAACCAGTATCAGGG-1	T cells
GTAACCAGTCAACACT-1	T cells
GTAACCAGTCACTCTC-1	T cells
GTAACCAGTGGTCCCA-1	Epithelial cells
GTAACCATCCAAGAGG-1	Fibroblasts
GTAAGTCGTAACTAAG-1	Endothelial cells
GTAAGTCGTATGCAAA-1	T cells
GTAAGTCGTCTTCATT-1	Epithelial cells
GTAAGTCTCAGTGGGA-1	Fibroblasts
GTAATCGAGTCTGGAG-1	Fibroblasts
GTAATCGGTAGTCTTG-1	Fibroblasts
GTAATCGTCACCTGGG-1	DC
GTAATGCCACCTCGTT-1	T cells
GTAATGCGTCCCACGA-1	NK cells
GTAATGCTCCTATGGA-1	Monocytes
GTACAACAGCCACAAG-1	Fibroblasts
GTACAACAGCCTAGGA-1	Epithelial cells
GTACAACCAAACTCGT-1	Epithelial cells
GTACAACCAGAGGCTA-1	Fibroblasts
GTACAACGTCATCGCG-1	T cells
GTACAACGTTCAGCGC-1	T cells
GTACAGTAGCAAATGT-1	Macrophages
GTACAGTAGTGAGCCA-1	Monocytes
GTACAGTAGTTGTCAC-1	Monocytes
GTACAGTCACACAGCC-1	T cells
GTACAGTGTCGTAATC-1	Monocytes
GTACAGTGTGTCCGGT-1	T cells
GTACAGTGTGTCTAAC-1	T cells
GTAGAAAAGAAGTCTA-1	Endothelial cells
GTAGAAAAGCCAAGGT-1	Fibroblasts
GTAGAGGAGTTAACGA-1	Macrophages
GTAGAGGCACCAGCTG-1	pDC
GTAGAGGCACTTCCTG-1	Monocytes
GTAGAGGGTGATAGAT-1	Fibroblasts
GTAGAGGGTTGCCATA-1	T cells
GTAGAGGTCTTGGATG-1	Endothelial cells
GTAGATCGTAGGCAAC-1	Monocytes
GTAGCTAAGGCTTTCA-1	Epithelial cells
GTAGCTACAGAGCTAG-1	Fibroblasts
GTAGCTATCAATCGGT-1	T cells
GTAGCTATCAGACATC-1	Fibroblasts
GTAGCTATCCACGTGG-1	Epithelial cells
GTAGCTATCTGATTCT-1	T cells
GTAGGAGAGGCAATGC-1	pDC
GTAGGAGCAGACCTGC-1	Epithelial cells
GTAGGAGGTGGGCTCT-1	Fibroblasts
GTAGGAGGTTATGTGC-1	B cells
GTAGGAGGTTCAAAGA-1	pDC
GTAGGTTAGGAGGGTG-1	pDC
GTAGGTTCACGACGAA-1	Fibroblasts
GTAGGTTGTCATAGTC-1	Epithelial cells
GTAGGTTGTTGGGCCT-1	Macrophages
GTAGGTTTCTGCGGCA-1	DC
GTAGTACAGCTGCGAA-1	Endothelial cells
GTAGTACCAGAGGTTG-1	T cells
GTAGTACTCACGATCA-1	Fibroblasts
GTAGTACTCTTGGCTC-1	B cells
GTATTGGGTAAGATTG-1	Endothelial cells
GTATTGGGTAGCGATG-1	Endothelial cells
GTATTGGGTCGCAGTC-1	Fibroblasts
GTATTGGGTTAGAAGT-1	Epithelial cells
GTATTGGTCGGCTGTG-1	B cells
GTATTGGTCTAGATCG-1	Fibroblasts
GTATTTCAGCGCATCC-1	Fibroblasts
GTATTTCAGGGTTAAT-1	Fibroblasts
GTATTTCAGTATGGAT-1	Epithelial cells
GTATTTCCAATAGTCC-1	T cells
GTATTTCGTAAGTCAA-1	Fibroblasts
GTATTTCGTCGCACAC-1	Fibroblasts
GTATTTCTCACATTGG-1	T cells
GTATTTCTCTACACTT-1	T cells
GTCAAACAGACATAAC-1	Endothelial cells
GTCAAACAGCATCAAA-1	Epithelial cells
GTCAAACCAACAGTGG-1	Epithelial cells
GTCAAACCAAGCCTGC-1	T cells
GTCAAACCACGACGCT-1	Epithelial cells
GTCAAACCAGCACAAG-1	Macrophages
GTCAAACCAGTCGAGA-1	T cells
GTCAAACGTGAGTTGG-1	Epithelial cells
GTCAAACTCACCGCTT-1	Monocytes
GTCAAACTCATCCTGC-1	T cells
GTCAAACTCATCTCTA-1	Endothelial cells
GTCAAACTCCTCTCTT-1	T cells
GTCAAACTCGCCGAAC-1	T cells
GTCAAACTCTGCTGAA-1	Epithelial cells
GTCAAGTCAACCGCCA-1	T cells
GTCAAGTCAATGGCCC-1	Epithelial cells
GTCAAGTGTGTGATGG-1	Fibroblasts
GTCAAGTTCATGCCAA-1	T cells
GTCACGGAGATTGACA-1	Epithelial cells
GTCACGGAGTCTTCCC-1	T cells
GTCACGGCAAATGGTA-1	Epithelial cells
GTCACGGCACAACGCC-1	Epithelial cells
GTCACGGCACTGAGGA-1	Epithelial cells
GTCACGGCAGCCGGTT-1	Monocytes
GTCACGGGTGAGTCAG-1	T cells
GTCACGGTCCCGAACG-1	Endothelial cells
GTCACGGTCCTGCCAT-1	T cells
GTCACTCAGACTCCGC-1	T cells
GTCACTCAGATCGGTG-1	T cells
GTCACTCAGGGAGTTC-1	Endothelial cells
GTCACTCAGGGATCAC-1	Epithelial cells
GTCACTCAGTTTGTCG-1	Epithelial cells
GTCACTCCAACGGCCT-1	T cells
GTCACTCCAGATACCT-1	Fibroblasts
GTCACTCGTGACGTCC-1	Fibroblasts
GTCACTCGTGGGCTTC-1	Endothelial cells
GTCACTCTCTACACTT-1	Fibroblasts
GTCAGCGAGGTACAAT-1	Fibroblasts
GTCAGCGCAAATGCGG-1	Monocytes
GTCAGCGGTCCCACGA-1	NK cells
GTCAGCGGTGTAGCAG-1	T cells
GTCAGCGGTGTTGATC-1	Macrophages
GTCAGCGGTGTTTGCA-1	Fibroblasts
GTCAGCGTCAGGAAGC-1	Epithelial cells
GTCATCCAGAAACACT-1	Endothelial cells
GTCATCCAGTAGGATT-1	Epithelial cells
GTCATCCAGTGACCTT-1	Fibroblasts
GTCATCCCACTGGCGT-1	T cells
GTCATCCCATGGAATA-1	T cells
GTCATCCGTAGGTTTC-1	Fibroblasts
GTCATCCGTCCGAAGA-1	Epithelial cells
GTCATCCGTGCGGTAA-1	T cells
GTCATCCGTTTCGTGA-1	Epithelial cells
GTCATCCTCTGCTTAT-1	Fibroblasts
GTCATGAAGACCAAAT-1	T cells
GTCATGAAGGTAAACT-1	pDC
GTCATGACAGAACTCT-1	T cells
GTCATGACAGATACTC-1	Fibroblasts
GTCATGAGTAGCTGTT-1	T cells
GTCATGAGTCCGGCAT-1	T cells
GTCATGAGTTGGACCC-1	Epithelial cells
GTCATTTAGGTAAACT-1	Macrophages
GTCATTTAGTGCGCTC-1	NK cells
GTCATTTCAAGAGAGA-1	T cells
GTCATTTGTCACGCTG-1	T cells
GTCATTTGTCTTCGAA-1	Macrophages
GTCATTTGTGGCCTCA-1	Epithelial cells
GTCATTTTCATGCCCT-1	Fibroblasts
GTCATTTTCCGAGAAG-1	pDC
GTCCACTAGTTAGTAG-1	Fibroblasts
GTCCACTGTGGAAGTC-1	Macrophages
GTCCACTGTTGCTAGT-1	Fibroblasts
GTCCACTTCCATTTCA-1	T cells
GTCCACTTCGGTCTAA-1	T cells
GTCCCATAGACGGTTG-1	Fibroblasts
GTCCCATAGTCGCTAT-1	NK cells
GTCCCATCAAGAAACT-1	T cells
GTCCCATCACAATGCT-1	Macrophages
GTCCCATGTTGACTGT-1	Macrophages
GTCCCATTCATCCCGT-1	Macrophages
GTCCCATTCTACTGAG-1	Epithelial cells
GTCCCATTCTTCCCGA-1	NK cells
GTCCTCAAGACACACG-1	Monocytes
GTCCTCAAGGGAGTTC-1	Fibroblasts
GTCCTCAAGGTTCAGG-1	Fibroblasts
GTCCTCACACCCAAGC-1	Endothelial cells
GTCCTCAGTAACGCGA-1	T cells
GTCCTCATCACTGTTT-1	Fibroblasts
GTCCTCATCCAATCCC-1	Fibroblasts
GTCCTCATCGACGTCG-1	T cells
GTCCTCATCGCTGTTC-1	Monocytes
GTCCTCATCTACTGAG-1	T cells
GTCGAATAGCTCGGCT-1	Epithelial cells
GTCGAATAGGGAGGTG-1	DC
GTCGAATAGTCATAGA-1	pDC
GTCGAATCACAAATGA-1	T cells
GTCGAATGTAACCCTA-1	T cells
GTCGAATGTAGCGCCT-1	Epithelial cells
GTCGAATGTCCTACGG-1	Monocytes
GTCGAATGTGTTCCAA-1	pDC
GTCGAATGTTCCCAAA-1	Epithelial cells
GTCGAATGTTGCATGT-1	Macrophages
GTCGAATTCAAGGTGG-1	Fibroblasts
GTCGAATTCCGTGCGA-1	T cells
GTCGAATTCTCCTGAC-1	Fibroblasts
GTCGAATTCTCTGCCA-1	Epithelial cells
GTCGCGAAGGTCTGGA-1	Fibroblasts
GTCGCGACACACGCCA-1	Fibroblasts
GTCGCGAGTACTCGTA-1	pDC
GTCGCGAGTGCCTATA-1	DC
GTCGCGAGTTGCTCGG-1	Fibroblasts
GTCGCGATCCGTACGG-1	Endothelial cells
GTCGCGATCGTCAACA-1	NK cells
GTCGTAAAGTGTTCCA-1	Monocytes
GTCGTAAAGTTGGACG-1	DC
GTCGTAAAGTTTCAGC-1	Epithelial cells
GTCGTAACAAGACCTT-1	Fibroblasts
GTCGTAACACAAGCAG-1	Fibroblasts
GTCGTAACACCCTATC-1	T cells
GTCGTAACAGATAAAC-1	Monocytes
GTCGTAAGTAGGACTG-1	T cells
GTCGTAAGTCACAGAG-1	Fibroblasts
GTCGTAAGTTCGGCGT-1	Epithelial cells
GTCGTAATCAACCTCC-1	B cells
GTCGTAATCTCGCGTT-1	Epithelial cells
GTCGTTCAGACAACAT-1	T cells
GTCGTTCAGGACTGGT-1	Fibroblasts
GTCGTTCCACACCTAA-1	pDC
GTCGTTCCATGTGCTA-1	Fibroblasts
GTCGTTCGTGCTCTTC-1	Monocytes
GTCGTTCTCAATCCGA-1	T cells
GTCGTTCTCTCGTCGT-1	Endothelial cells
GTCTACCAGACCAAAT-1	T cells
GTCTACCAGGAATTAC-1	T cells
GTCTACCAGGATACCG-1	T cells
GTCTACCAGTAAGCAT-1	Fibroblasts
GTCTACCAGTGCAAAT-1	Fibroblasts
GTCTACCCAAGTGGAC-1	Epithelial cells
GTCTACCCACCATAAC-1	Fibroblasts
GTCTACCCATGTCGTA-1	Epithelial cells
GTCTACCGTAAGTAGT-1	B cells
GTCTACCGTAGGGAGG-1	Fibroblasts
GTCTACCGTCCACAGC-1	Fibroblasts
GTCTACCGTCCAGAAG-1	Fibroblasts
GTCTACCTCTGAATGC-1	Fibroblasts
GTCTAGACACATACTG-1	Fibroblasts
GTCTAGACACCAGTTA-1	T cells
GTCTAGAGTATCGTTG-1	T cells
GTCTAGAGTCCCTGTT-1	Fibroblasts
GTCTAGAGTTACCGTA-1	B cells
GTCTAGAGTTGCCAAT-1	T cells
GTCTAGATCAGTCAGT-1	Endothelial cells
GTCTAGATCCGTCAAA-1	Fibroblasts
GTCTAGATCGCTTTAT-1	T cells
GTCTAGATCGTCCATC-1	Fibroblasts
GTCTCACAGTGCTACT-1	Fibroblasts
GTCTCACCAGGCACTC-1	Fibroblasts
GTCTCACGTATGAAAC-1	Fibroblasts
GTCTCACTCCCGTTCA-1	T cells
GTCTGTCAGGAAAGGT-1	B cells
GTCTGTCAGTATCCTG-1	Fibroblasts
GTCTGTCAGTCACGCC-1	Fibroblasts
GTCTGTCCACCTAAAC-1	Epithelial cells
GTCTGTCCATCACCAA-1	T cells
GTCTGTCCATCTGGGC-1	Plasma cells
GTCTGTCGTTAGAGTA-1	T cells
GTCTGTCTCCAGTGTA-1	DC
GTCTTTAAGCCTTGAT-1	pDC
GTCTTTAAGGCAATGC-1	NK cells
GTCTTTAGTATCGTTG-1	T cells
GTCTTTAGTCAAGTTC-1	Fibroblasts
GTCTTTATCGCGTGCA-1	T cells
GTCTTTATCGGCCAAC-1	T cells
GTCTTTATCTCCTGAC-1	T cells
GTGACGCAGATCGGTG-1	Fibroblasts
GTGACGCGTCTGTGCG-1	Fibroblasts
GTGACGCGTTCCGCAG-1	Monocytes
GTGAGCCAGCCAAGGT-1	Fibroblasts
GTGAGCCCAGCGGTTC-1	B cells
GTGAGCCTCAGATGCT-1	pDC
GTGAGCCTCTGACGCG-1	Macrophages
GTGAGCCTCTTGATTC-1	T cells
GTGAGGAAGGATTACA-1	T cells
GTGAGGACAAGTGCTT-1	T cells
GTGAGGAGTGATGAAT-1	T cells
GTGAGGAGTGTACAGG-1	Fibroblasts
GTGAGGAGTGTGTGTT-1	Fibroblasts
GTGAGGAGTTACCGTA-1	Epithelial cells
GTGAGGATCACTGAAC-1	Fibroblasts
GTGAGGATCACTGGTA-1	Monocytes
GTGAGGATCAGCCTTC-1	Macrophages
GTGAGGATCCGACAGC-1	Fibroblasts
GTGAGGATCTACAGGT-1	Epithelial cells
GTGAGTTAGACCCGCT-1	Fibroblasts
GTGAGTTCACAATGAA-1	Plasma cells
GTGAGTTCACAGCCTG-1	Fibroblasts
GTGAGTTCACCGTCGA-1	Monocytes
GTGAGTTCAGGTGTGA-1	Epithelial cells
GTGAGTTCAGGTTTAC-1	pDC
GTGAGTTCATTGAGCT-1	T cells
GTGAGTTGTATGGTAA-1	Fibroblasts
GTGAGTTGTGTGTCCG-1	T cells
GTGAGTTTCAAATGCC-1	Epithelial cells
GTGATGTCAGCCGTCA-1	T cells
GTGATGTCATATGAAG-1	Fibroblasts
GTGATGTGTCGCAGTC-1	B cells
GTGATGTGTTCAACGT-1	Fibroblasts
GTGATGTTCCCTCTCC-1	Fibroblasts
GTGCACGCAAGCTACT-1	Epithelial cells
GTGCACGCATTCAGCA-1	T cells
GTGCACGGTGCCGTAC-1	Fibroblasts
GTGCACGTCCACTTTA-1	Macrophages
GTGCACGTCCTGTACC-1	Endothelial cells
GTGCACGTCTGCGTCT-1	Epithelial cells
GTGCAGCAGACTACCT-1	T cells
GTGCAGCAGAGGGCGA-1	T cells
GTGCAGCAGGAGATAG-1	T cells
GTGCAGCAGGCTGTAG-1	Epithelial cells
GTGCAGCAGTCTAGAA-1	Epithelial cells
GTGCAGCAGTCTGCAT-1	Fibroblasts
GTGCAGCGTCTTCTAT-1	B cells
GTGCGTGAGCCTTCTC-1	Plasma cells
GTGCGTGCAACCGGAA-1	Fibroblasts
GTGCGTGGTCGGAACA-1	T cells
GTGCTGGAGGTGCAGT-1	Fibroblasts
GTGCTGGAGGTGTGAC-1	T cells
GTGCTGGGTGAGGATC-1	Plasma cells
GTGCTGGGTGCGGTAA-1	Macrophages
GTGCTGGGTGGAGAAA-1	Monocytes
GTGCTGGTCACATTGG-1	T cells
GTGCTGGTCAGATTGC-1	Endothelial cells
GTGCTGGTCGGCCTTT-1	T cells
GTGCTGGTCTCATTAC-1	Fibroblasts
GTGCTTCAGGTGCATG-1	T cells
GTGCTTCCACTTGGGC-1	NK cells
GTGCTTCCATGTTCAG-1	Fibroblasts
GTGCTTCGTTACAGCT-1	Monocytes
GTGCTTCTCACGTAGT-1	Epithelial cells
GTGCTTCTCACTGCTC-1	Monocytes
GTGCTTCTCAGTGGGA-1	Macrophages
GTGCTTCTCCAGGACC-1	Fibroblasts
GTGCTTCTCCGCGAGT-1	T cells
GTGCTTCTCTTAGCCC-1	Fibroblasts
GTGGAAGAGATCGCTT-1	B cells
GTGGAAGAGCCGTTAT-1	Macrophages
GTGGAGAAGCTCATAC-1	Fibroblasts
GTGGAGACACCTGAAT-1	T cells
GTGGAGACAGCGTACC-1	T cells
GTGGAGACAGTTCTAG-1	Fibroblasts
GTGGAGATCAACTGAC-1	Fibroblasts
GTGGAGATCGACACCG-1	Monocytes
GTGGCGTAGACCCTTA-1	Epithelial cells
GTGGCGTAGACCTTTG-1	T cells
GTGGCGTGTCGATGCC-1	Fibroblasts
GTGGCGTGTGCCGTTG-1	T cells
GTGGCGTGTGCCTACG-1	Fibroblasts
GTGGCGTGTTAAACCC-1	Fibroblasts
GTGGCGTGTTAAGGGC-1	T cells
GTGGCGTGTTACCCTC-1	Fibroblasts
GTGGCGTGTTCTAAGC-1	T cells
GTGGGAACACTTGGCG-1	Fibroblasts
GTGGGAACAGCTCGGT-1	T cells
GTGGGAACATTGAGGG-1	T cells
GTGGGAAGTCACAGAG-1	Fibroblasts
GTGGTTAAGCACTCGC-1	T cells
GTGGTTAAGTAGGTTA-1	Fibroblasts
GTGGTTACAAATGGCG-1	DC
GTGGTTACACATGAAA-1	Fibroblasts
GTGGTTATCTGAGTCA-1	Monocytes
GTGTAACAGTGCCAGA-1	Monocytes
GTGTCCTAGCCATATC-1	T cells
GTGTCCTCAATACGCT-1	T cells
GTGTCCTGTGAAGCGT-1	NK cells
GTGTCCTTCATGCAGT-1	T cells
GTGTCCTTCCGCGAGT-1	Monocytes
GTGTCCTTCTTACACT-1	Fibroblasts
GTGTGATAGCCTTCTC-1	Fibroblasts
GTGTGATAGCTACAAA-1	NK cells
GTGTGATAGTAGCAAT-1	NK cells
GTGTGATCAGCGAGTA-1	Monocytes
GTGTGATGTCTAACTG-1	T cells
GTGTGATGTGATGTAA-1	Macrophages
GTGTGATGTGTGTGTT-1	Fibroblasts
GTGTGGCAGATTAGCA-1	Monocytes
GTGTGGCAGTTCCGGC-1	Endothelial cells
GTGTGGCCACCAAATC-1	T cells
GTGTGGCGTACAAACA-1	Fibroblasts
GTGTGGCGTATATGGA-1	Fibroblasts
GTGTGGCGTCAGGAGT-1	Monocytes
GTGTGGCGTGTTGCCG-1	Epithelial cells
GTGTGGCGTTACGCCG-1	Epithelial cells
GTGTGGCTCGCTACGG-1	Fibroblasts
GTGTTAGAGGTGCCTC-1	Epithelial cells
GTGTTAGCAAAGGCTG-1	Epithelial cells
GTGTTAGCAGTCTCTC-1	T cells
GTGTTAGGTAACCCGC-1	T cells
GTGTTAGGTAACTAAG-1	T cells
GTGTTAGGTCTTCTAT-1	Fibroblasts
GTGTTAGTCCTAAACG-1	T cells
GTGTTCCAGACTTCAC-1	B cells
GTGTTCCAGATTACCC-1	Fibroblasts
GTGTTCCGTGGCTTGC-1	Fibroblasts
GTGTTCCGTGTAAATG-1	Macrophages
GTGTTCCGTGTTACAC-1	Fibroblasts
GTTACAGAGGCAGCTA-1	Epithelial cells
GTTACAGAGGTGCTAG-1	Fibroblasts
GTTACAGAGTTGGGAC-1	Epithelial cells
GTTACAGCAAAGCACG-1	Fibroblasts
GTTACAGCAACTCGAT-1	Fibroblasts
GTTACAGGTCACAATC-1	T cells
GTTACAGGTCCAAATC-1	T cells
GTTACAGGTCCCTCAT-1	Endothelial cells
GTTACAGGTTCAGCTA-1	Fibroblasts
GTTACAGGTTGTATGC-1	T cells
GTTACAGTCAGACCGC-1	Epithelial cells
GTTACAGTCATCCCGT-1	NK cells
GTTACAGTCCATAGGT-1	pDC
GTTACAGTCGACATAC-1	Epithelial cells
GTTACCCAGCTCGACC-1	T cells
GTTACCCCACGGCCAT-1	ILC
GTTACCCCATTAAAGG-1	Fibroblasts
GTTACCCTCCTGGGAC-1	Epithelial cells
GTTACCCTCGAGTTGT-1	Epithelial cells
GTTACCCTCGCATAGT-1	Epithelial cells
GTTACCCTCTAGACAC-1	T cells
GTTACCCTCTTCGTAT-1	Monocytes
GTTACGAAGTCTGGAG-1	T cells
GTTACGACAACGCATT-1	Epithelial cells
GTTACGACAATAAGGT-1	Fibroblasts
GTTACGACATACTGAC-1	Fibroblasts
GTTACGACATCGGATT-1	T cells
GTTACGAGTATTTCGG-1	pDC
GTTACGAGTGGTCCCA-1	T cells
GTTACGAGTGTCACAT-1	Epithelial cells
GTTACGAGTTCCGCTT-1	Epithelial cells
GTTACGATCCTGGTCT-1	T cells
GTTACGATCTGGTTGA-1	T cells
GTTAGACCACGGTGAA-1	T cells
GTTAGACGTAAGTAGT-1	Fibroblasts
GTTAGTGAGGACGCTA-1	Fibroblasts
GTTAGTGAGGCTTAAA-1	T cells
GTTAGTGAGTCTACCA-1	ILC
GTTAGTGAGTGAGGCT-1	T cells
GTTAGTGGTAAGATAC-1	T cells
GTTAGTGGTAGTTCCA-1	Fibroblasts
GTTAGTGTCATGGTAC-1	Fibroblasts
GTTAGTGTCGAGTGAG-1	T cells
GTTAGTGTCTCCACTG-1	Epithelial cells
GTTATGGAGCACTGGA-1	NK cells
GTTATGGCAGTCGGAA-1	Epithelial cells
GTTATGGGTCTACAGT-1	Monocytes
GTTATGGGTGATTCTG-1	DC
GTTATGGTCATACGAC-1	Epithelial cells
GTTATGGTCATCTACT-1	T cells
GTTATGGTCATCTGTT-1	Epithelial cells
GTTATGGTCCAAATGC-1	T cells
GTTATGGTCTACTATC-1	T cells
GTTATGGTCTCGCAGG-1	T cells
GTTCATTAGAGCACTG-1	Fibroblasts
GTTCATTGTCTGCATA-1	T cells
GTTCCGTAGGATGTTA-1	T cells
GTTCCGTAGTCTGCAT-1	Fibroblasts
GTTCCGTCACAATGTC-1	Epithelial cells
GTTCCGTGTCCTCAGG-1	T cells
GTTCCGTGTGTTGATC-1	Fibroblasts
GTTCCGTGTTCTCGCT-1	T cells
GTTCCGTTCATCGGGC-1	Fibroblasts
GTTCCGTTCGAGATGG-1	Monocytes
GTTCCGTTCGCAGATT-1	Fibroblasts
GTTCGCTAGAAGCTCG-1	Epithelial cells
GTTCGCTAGGGATCTG-1	Epithelial cells
GTTCGCTCAGACTGCC-1	Fibroblasts
GTTCGCTCATACAGAA-1	T cells
GTTCGCTGTAGGAGTC-1	Fibroblasts
GTTCGCTGTCAACCAT-1	Epithelial cells
GTTCGCTGTCCTGTCT-1	Fibroblasts
GTTCGCTGTTTGAAAG-1	Fibroblasts
GTTCGCTTCTAGATCG-1	T cells
GTTCTATAGAACGCGT-1	T cells
GTTCTATAGTGAATAC-1	T cells
GTTCTATCACAAGTTC-1	T cells
GTTCTATTCCTAGCTC-1	Fibroblasts
GTTGAACCAATCGCAT-1	Fibroblasts
GTTGAACCAGTGCCTG-1	T cells
GTTGAACGTCGTACTA-1	Fibroblasts
GTTGAACGTTAGGACG-1	Endothelial cells
GTTGAACTCCAATGCA-1	Fibroblasts
GTTGAACTCGCTTTAT-1	Macrophages
GTTGCGGAGACTGGGT-1	Fibroblasts
GTTGCGGAGCGACTGA-1	Fibroblasts
GTTGCGGTCACTGAAC-1	Epithelial cells
GTTGCGGTCCCGAGGT-1	pDC
GTTGCGGTCTCCCTAG-1	Epithelial cells
GTTGCTCCAAGTATCC-1	T cells
GTTGCTCGTAGTTCCA-1	Endothelial cells
GTTGCTCTCCCTCTAG-1	Fibroblasts
GTTGTAGAGGTCTACT-1	Endothelial cells
GTTGTAGGTCACGACC-1	Fibroblasts
GTTGTAGGTTGCGAAG-1	Epithelial cells
GTTGTAGTCCACGAAT-1	NK cells
GTTGTCCCAGTCGGAA-1	B cells
GTTGTCCTCAAGTCTG-1	Epithelial cells
GTTGTCCTCCCGAGAC-1	T cells
GTTGTCCTCTAAGGAA-1	B cells
GTTGTGAAGTCAGGGT-1	Fibroblasts
GTTGTGAGTATCGCGC-1	Monocytes
GTTGTGAGTCGGAAAC-1	ILC
GTTGTGATCATGGGAG-1	ILC
GTTTACTCACTCAAGT-1	Monocytes
GTTTACTCAGAGAATT-1	Epithelial cells
GTTTACTCATCCAATG-1	Epithelial cells
GTTTACTGTTGAGAGC-1	T cells
GTTTACTTCATTGCGA-1	Fibroblasts
GTTTACTTCGCCTAGG-1	Epithelial cells
GTTTACTTCGGTCAGC-1	Macrophages
GTTTGGAAGCCGCTTG-1	T cells
GTTTGGAAGGCACCAA-1	Epithelial cells
GTTTGGACAAACCATC-1	Fibroblasts
GTTTGGACACTAGGCC-1	Fibroblasts
GTTTGGACAGACGCTC-1	Epithelial cells
GTTTGGAGTAAGCAAT-1	T cells
GTTTGGAGTCTTGGTA-1	Monocytes
GTTTGGAGTGGAATGC-1	T cells
GTTTGGATCTCAACCC-1	Monocytes
TAACACGCAGAAGCTG-1	Fibroblasts
TAACACGCAGCTATAC-1	T cells
TAACACGCAGGTTCAT-1	B cells
TAACACGGTAACGATA-1	Fibroblasts
TAACACGGTCTTTATC-1	T cells
TAACACGGTTTCGACA-1	Fibroblasts
TAACACGTCCGTCACT-1	NK cells
TAACACGTCTTAGCAG-1	Epithelial cells
TAACCAGAGTCGTCTA-1	T cells
TAACCAGAGTCTGTAC-1	Monocytes
TAACCAGCAGTTTGGT-1	DC
TAACCAGCATCATGAC-1	T cells
TAACCAGTCACCCTCA-1	T cells
TAACCAGTCATCGTAG-1	T cells
TAACCAGTCTTCCCAG-1	Macrophages
TAACGACAGTGCCGAA-1	B cells
TAACGACAGTGGTCAG-1	Fibroblasts
TAACGACCACTCCGGA-1	Fibroblasts
TAACGACCAGTGTGGA-1	Monocytes
TAACGACGTAGCTTAC-1	B cells
TAACGACGTTGTGCAT-1	T cells
TAACGACTCGAAGCCC-1	T cells
TAACGACTCGAGATAA-1	Fibroblasts
TAACTTCAGAGTCACG-1	T cells
TAACTTCAGTGTTCAC-1	Monocytes
TAACTTCCAATAACGA-1	Monocytes
TAACTTCGTCGAGATG-1	NK cells
TAACTTCGTTCCAAAC-1	Epithelial cells
TAACTTCTCCTTATCA-1	T cells
TAACTTCTCGGTGTTA-1	T cells
TAAGCACAGAAATCCA-1	Fibroblasts
TAAGCACAGGAGAGGC-1	Endothelial cells
TAAGCACAGTGTAGTA-1	Monocytes
TAAGCACGTCACAATC-1	T cells
TAAGCACGTGGACTAG-1	Fibroblasts
TAAGCACGTTTCCAAG-1	T cells
TAAGCACTCGCCTCTA-1	Fibroblasts
TAAGCACTCGTCAACA-1	T cells
TAAGCCAAGCCTGTCG-1	B cells
TAAGCCACACCCGTAG-1	NK cells
TAAGCCACACGTGAGA-1	T cells
TAAGCCACAGCGTTTA-1	T cells
TAAGCGTAGACGCATG-1	Fibroblasts
TAAGCGTCACCCTGAG-1	T cells
TAAGCGTCACTACACA-1	T cells
TAAGCGTTCCCGAATA-1	Endothelial cells
TAAGTCGAGTCAGCCC-1	Epithelial cells
TAAGTCGGTAAGCAAT-1	Epithelial cells
TAAGTCGTCAGCAGAG-1	Epithelial cells
TAAGTCGTCCCGTGTT-1	Monocytes
TAAGTCGTCGAAGGAC-1	Macrophages
TAAGTCGTCTCAGTCC-1	T cells
TAAGTCGTCTCTTCAA-1	DC
TAATCTCAGCATGGGT-1	T cells
TAATCTCCAAGACCGA-1	Fibroblasts
TAATCTCCACTTGAGT-1	T cells
TAATCTCGTCCCTCAT-1	Monocytes
TAATCTCGTTCCATTT-1	Fibroblasts
TAATCTCTCTGAACGT-1	T cells
TAATTCCCACCTTCGT-1	Fibroblasts
TAATTCCCAGAGTCAG-1	Fibroblasts
TAATTCCCATCGGCCA-1	Fibroblasts
TAATTCCGTAATTGGA-1	Epithelial cells
TACAACGAGAGTTGAT-1	T cells
TACAACGCACCTCAGG-1	T cells
TACAACGCACGCACCA-1	Fibroblasts
TACAACGCACTACGGC-1	Fibroblasts
TACAACGCAGAGTGTG-1	T cells
TACAACGCAGTGCCTG-1	Macrophages
TACAACGGTGAGTAAT-1	Monocytes
TACAACGGTGATCGTT-1	T cells
TACACCCCACAATGTC-1	B cells
TACACCCCATGGCGCT-1	Macrophages
TACACCCGTGCTCTTC-1	Macrophages
TACACCCGTTCGTGCG-1	B cells
TACACCCGTTCTTGCC-1	Epithelial cells
TACACCCGTTGCAACT-1	Epithelial cells
TACACCCTCCTAGAGT-1	Epithelial cells
TACAGGTCACAGGATG-1	B cells
TACAGGTCACGGCGTT-1	Epithelial cells
TACAGGTCATCGTGGC-1	Endothelial cells
TACAGGTCATGGGTTT-1	T cells
TACAGGTGTACGAGTG-1	T cells
TACAGGTGTAGTCACT-1	B cells
TACAGGTGTCCATCTC-1	Mast cells
TACAGGTTCGCACGGT-1	T cells
TACATTCAGCACACAG-1	T cells
TACATTCAGTAAGGGA-1	Epithelial cells
TACATTCCACGACGCT-1	Epithelial cells
TACATTCGTACGTGAG-1	pDC
TACATTCTCGAGAATA-1	T cells
TACATTCTCTATCGGA-1	Epithelial cells
TACATTCTCTCTCGCA-1	T cells
TACCCACCAGTCGGAA-1	Epithelial cells
TACCCACGTACACGTT-1	NK cells
TACCCACGTAGCTAAA-1	Monocytes
TACCCACGTCCACTCT-1	Fibroblasts
TACCCACTCGTCCATC-1	Endothelial cells
TACCCACTCTACCCAC-1	Monocytes
TACCCGTAGTCTAGAA-1	Epithelial cells
TACCCGTAGTGAGGTC-1	T cells
TACCCGTCACAAATGA-1	T cells
TACCCGTCACATGAAA-1	Fibroblasts
TACCCGTCAGACTGCC-1	Fibroblasts
TACCCGTCATGAGAAT-1	T cells
TACCCGTCATGTGTCA-1	Macrophages
TACCCGTGTGGAATGC-1	Epithelial cells
TACCCGTTCGGTATGT-1	T cells
TACCCGTTCTGGGCAC-1	T cells
TACCGAAAGACAAGCC-1	Epithelial cells
TACCGAAAGTGGATAT-1	T cells
TACCGAAGTACGATTC-1	Monocytes
TACCGAAGTGTTTACG-1	Fibroblasts
TACCGAATCAAGCTGT-1	T cells
TACCGAATCAGCTGTA-1	pDC
TACCGAATCGTACACA-1	T cells
TACCGGGAGACTGGGT-1	Plasma cells
TACCGGGAGCGTCAAG-1	Epithelial cells
TACCGGGCAGAGATGC-1	Epithelial cells
TACCGGGCAGTTCACA-1	Fibroblasts
TACCGGGTCAACTACG-1	T cells
TACCGGGTCAGCCTCT-1	Fibroblasts
TACCTCGCACCCTAAA-1	Endothelial cells
TACCTCGCAGGACATG-1	T cells
TACCTCGCATCTAGAC-1	T cells
TACCTGCGTTACACTG-1	Fibroblasts
TACCTGCGTTATAGCC-1	T cells
TACGCTCAGTGGAATT-1	Fibroblasts
TACGCTCAGTTTGCTG-1	DC
TACGCTCCACACCGAC-1	T cells
TACGCTCGTAGGCAGT-1	Endothelial cells
TACGGGCAGCAAGCCA-1	Endothelial cells
TACGGGCAGGTTGGAC-1	T cells
TACGGGCGTCTATGAC-1	pDC
TACGGGCGTTATCCAG-1	pDC
TACGGGCTCAGAACCT-1	Fibroblasts
TACGGGCTCAGACCGC-1	B cells
TACGGGCTCCTACACC-1	Epithelial cells
TACGGGCTCTCTAGGA-1	T cells
TACGGTACAAGCTGTT-1	Epithelial cells
TACGGTACATAACAGA-1	T cells
TACGGTAGTGGATTTC-1	Fibroblasts
TACGGTAGTTGTGCAT-1	T cells
TACGGTATCCTATGGA-1	T cells
TACGTCCAGGTTCACT-1	Fibroblasts
TACGTCCAGTACAGCG-1	Epithelial cells
TACGTCCCAACCACAT-1	Fibroblasts
TACGTCCCAAGTACCT-1	Fibroblasts
TACGTCCCACATACTG-1	Epithelial cells
TACGTCCCATAGCACT-1	Fibroblasts
TACGTCCGTTCTCGCT-1	T cells
TACGTCCTCCACGGGT-1	Macrophages
TACGTCCTCCGATAAC-1	T cells
TACTGCCAGAAGCGGG-1	Monocytes
TACTGCCAGTAAACGT-1	T cells
TACTGCCCAAAGAGTT-1	Monocytes
TACTGCCCAACGTAAA-1	Epithelial cells
TACTGCCGTTGCGGCT-1	Fibroblasts
TACTGCCTCGACATTG-1	T cells
TACTGCCTCGATGGAG-1	DC
TACTGCCTCTGCTCTG-1	Fibroblasts
TACTTACAGGCGATAC-1	T cells
TACTTACAGTCTGTAC-1	Fibroblasts
TACTTACGTATCTTCT-1	Fibroblasts
TACTTACGTCCAGCGT-1	Epithelial cells
TACTTACGTGGCTACC-1	T cells
TACTTACTCTACTTCA-1	Macrophages
TACTTCAAGTGAGCCA-1	Macrophages
TACTTCACACTCAGAT-1	T cells
TACTTCACAGAGTTCT-1	T cells
TACTTCACAGTAGGAC-1	Fibroblasts
TACTTCAGTACTCGAT-1	Fibroblasts
TACTTCAGTCACAATC-1	Epithelial cells
TACTTCAGTCACCACG-1	Epithelial cells
TACTTCAGTCGACTGC-1	Macrophages
TACTTCAGTTCGAGCC-1	Epithelial cells
TACTTGTAGCCTGCCA-1	pDC
TACTTGTCATAATGAG-1	T cells
TACTTGTGTGCCTAAT-1	NK cells
TACTTGTGTGGACTAG-1	Epithelial cells
TACTTGTGTTAGAGTA-1	Epithelial cells
TACTTGTTCATGGTAC-1	NK cells
TACTTGTTCCTCACTG-1	Fibroblasts
TACTTGTTCGGAGCAA-1	Epithelial cells
TAGACCAAGACCAAGC-1	Plasma cells
TAGACCACATCATCCC-1	T cells
TAGACCAGTAGCGCCT-1	Fibroblasts
TAGACCAGTAGTGATA-1	Fibroblasts
TAGACCAGTCCCTCAT-1	T cells
TAGACCAGTGCTATTG-1	T cells
TAGACCATCAGACCCG-1	Fibroblasts
TAGACCATCATCAGTG-1	Monocytes
TAGACCATCTCCCTAG-1	Epithelial cells
TAGACTGAGATCCTAC-1	T cells
TAGACTGAGCTTTCTT-1	NK cells
TAGACTGCAACAGTGG-1	Fibroblasts
TAGACTGCAGGTGAGT-1	T cells
TAGACTGGTCCTGTTC-1	T cells
TAGACTGGTGGAACAC-1	Epithelial cells
TAGACTGGTGTCCAAT-1	Monocytes
TAGACTGGTGTCGATT-1	T cells
TAGACTGTCGAACACT-1	NK cells
TAGACTGTCGAGAACG-1	T cells
TAGACTGTCTGTCCCA-1	T cells
TAGAGTCAGCGTCGAA-1	Epithelial cells
TAGAGTCAGCTGGTGA-1	T cells
TAGAGTCAGGGCCCTT-1	T cells
TAGAGTCAGTCTGTAC-1	Fibroblasts
TAGAGTCCATCTGTTT-1	DC
TAGAGTCGTCATACCA-1	Endothelial cells
TAGAGTCGTCCAAAGG-1	B cells
TAGAGTCGTGGGTCAA-1	Fibroblasts
TAGAGTCTCAAATGCC-1	Epithelial cells
TAGATCGAGACGTCGA-1	T cells
TAGATCGAGTGAGTGC-1	Fibroblasts
TAGATCGCAGCACCCA-1	Epithelial cells
TAGATCGCAGCTAACT-1	Fibroblasts
TAGATCGGTTCGGACC-1	T cells
TAGATCGTCGGCACTG-1	Epithelial cells
TAGCACAAGATGTAGT-1	T cells
TAGCACAAGGTAGCCA-1	Fibroblasts
TAGCACACAATAGGGC-1	T cells
TAGCACACAGAGATGC-1	Epithelial cells
TAGCACACATAAGCAA-1	T cells
TAGCACAGTCACCGAC-1	Fibroblasts
TAGCACAGTCCCTGAG-1	Fibroblasts
TAGCACAGTTCCGCGA-1	T cells
TAGCACATCAATCAGC-1	T cells
TAGCACATCAGCAGAG-1	T cells
TAGCACATCATCGCAA-1	Fibroblasts
TAGGAGGAGAATAACC-1	Fibroblasts
TAGGAGGAGATGGTCG-1	Fibroblasts
TAGGAGGAGATTAGTG-1	Fibroblasts
TAGGAGGAGTACAGCG-1	Fibroblasts
TAGGAGGAGTCACAGG-1	Fibroblasts
TAGGAGGGTCCCGTGA-1	Monocytes
TAGGAGGTCATGGAGG-1	T cells
TAGGAGGTCCGATGTA-1	T cells
TAGGGTTAGACCATTC-1	T cells
TAGGGTTAGAGGTGCT-1	T cells
TAGGGTTAGATGCCGA-1	Fibroblasts
TAGGGTTAGCCGCTTG-1	B cells
TAGGGTTCATCATGAC-1	T cells
TAGGGTTGTCCTTTGC-1	T cells
TAGGGTTGTCGTAATC-1	Endothelial cells
TAGGTACCACTACGGC-1	Fibroblasts
TAGGTACCATAATGCC-1	Fibroblasts
TAGGTACCATCGCCTT-1	Epithelial cells
TAGGTACGTCATGGCC-1	Fibroblasts
TAGGTACGTGCACATT-1	Fibroblasts
TAGGTACTCATCTACT-1	T cells
TAGGTACTCTGAGGTT-1	T cells
TAGGTTGAGCGACTGA-1	Epithelial cells
TAGGTTGAGTAGCTCT-1	Fibroblasts
TAGGTTGGTACAACGG-1	T cells
TAGGTTGGTCATCGCG-1	Monocytes
TAGGTTGTCAGGAAGC-1	Epithelial cells
TAGGTTGTCCATTGTT-1	Fibroblasts
TAGTGCAAGTCATCCA-1	Monocytes
TAGTGCACACTCCGGA-1	Epithelial cells
TAGTGCAGTTGTGTAC-1	T cells
TAGTGCATCGTAATGC-1	Epithelial cells
TAGTGCATCTCCCTAG-1	T cells
TATACCTAGGCATCAG-1	Fibroblasts
TATACCTGTACTCGAT-1	Fibroblasts
TATACCTGTCGATGCC-1	Endothelial cells
TATACCTGTTAACAGA-1	Monocytes
TATACCTGTTCCCAAA-1	Epithelial cells
TATACCTTCATGCAGT-1	T cells
TATACCTTCGTGGTAT-1	Epithelial cells
TATACCTTCTGCGGGT-1	pDC
TATATCCAGGATTCAA-1	Fibroblasts
TATATCCCATTGACTG-1	Epithelial cells
TATCAGGAGCTCCACG-1	Monocytes
TATCAGGAGTCATAGA-1	T cells
TATCAGGCAAAGCTCT-1	B cells
TATCAGGCACCAACAT-1	Fibroblasts
TATCAGGCATGACCCG-1	Monocytes
TATCAGGGTACTAACC-1	Macrophages
TATCAGGGTCGGAAAC-1	T cells
TATCAGGGTGACTCTA-1	Epithelial cells
TATCAGGGTGCTAGCC-1	T cells
TATCAGGTCCTTGACC-1	Epithelial cells
TATCAGGTCGCATTGA-1	Epithelial cells
TATCCTAAGCACTCAT-1	T cells
TATCCTAAGTGAGGTC-1	T cells
TATCCTACAGCTCTGG-1	ILC
TATCCTAGTATACGGG-1	Monocytes
TATCCTAGTCACCGAC-1	Epithelial cells
TATCGCCAGACCACGA-1	T cells
TATCGCCAGTGTACCT-1	Fibroblasts
TATCGCCCATCCTTCG-1	Fibroblasts
TATCTGTCAAATTAGG-1	Epithelial cells
TATCTGTCAACACTAC-1	Monocytes
TATCTGTCATAGGAGC-1	Fibroblasts
TATCTGTGTAACCCGC-1	Fibroblasts
TATCTTGAGAAATTCG-1	NK cells
TATCTTGCAATGAACA-1	Endothelial cells
TATCTTGGTAAGCTCT-1	Fibroblasts
TATCTTGGTCGCACGT-1	T cells
TATCTTGTCATGAAAG-1	Fibroblasts
TATCTTGTCGTTACCC-1	T cells
TATCTTGTCGTTTACT-1	T cells
TATCTTGTCTAGCCTC-1	T cells
TATGTTCAGAGGCGGA-1	T cells
TATGTTCAGCCTCCAG-1	Fibroblasts
TATGTTCAGGCCACTC-1	Epithelial cells
TATGTTCGTCTTACAG-1	Epithelial cells
TATGTTCTCCTGTTGC-1	T cells
TATGTTCTCGCAGTGC-1	Endothelial cells
TATTCCAAGCAGGTCA-1	Endothelial cells
TATTCCAAGCCGAACA-1	Fibroblasts
TATTCCAAGGATACAT-1	T cells
TATTCCAAGTTCCATG-1	Fibroblasts
TATTCCAGTTTACCTT-1	Fibroblasts
TATTCCATCTCTTAAC-1	T cells
TATTGCTAGCCACAAG-1	T cells
TATTGCTCAATTCGTG-1	T cells
TATTGCTGTTTGGAGG-1	Fibroblasts
TATTGGGAGAGAACCC-1	Fibroblasts
TATTGGGAGGCCATAG-1	Fibroblasts
TATTGGGCACTTCATT-1	Fibroblasts
TATTGGGGTGGGTATG-1	Fibroblasts
TATTGGGTCGACCATA-1	Fibroblasts
TATTTCGAGGGTTAGC-1	Epithelial cells
TATTTCGGTCATCACA-1	T cells
TATTTCGGTCTTCCGT-1	Epithelial cells
TATTTCGGTGTCATCA-1	Epithelial cells
TATTTCGGTGTTACTG-1	T cells
TATTTCGTCGTCGCTT-1	T cells
TCAAGACAGCGGTAGT-1	Epithelial cells
TCAAGACAGTAAACAC-1	Fibroblasts
TCAAGACAGTGGCCTC-1	T cells
TCAAGACTCAAGCCAT-1	Fibroblasts
TCAAGACTCGTGCAGC-1	T cells
TCAAGCAAGGAGAGTA-1	T cells
TCAAGCACAGAGGCTA-1	Epithelial cells
TCAAGCAGTCGAGCTC-1	T cells
TCAAGCAGTGAACGGT-1	T cells
TCAAGCAGTGAGCAGT-1	Fibroblasts
TCAAGCAGTGCATTTG-1	Epithelial cells
TCAAGCATCCATACTT-1	Macrophages
TCAAGCATCGATGCAT-1	Monocytes
TCAAGTGAGGAACTCG-1	Epithelial cells
TCAAGTGGTTAAGGGC-1	Fibroblasts
TCAAGTGTCCGGCAAC-1	Fibroblasts
TCAAGTGTCTTCCGTG-1	Fibroblasts
TCAATCTAGCTTCGTA-1	Epithelial cells
TCAATCTAGTGTCATC-1	Fibroblasts
TCAATCTCAGAGAAAG-1	T cells
TCAATCTCAGCCTATA-1	Epithelial cells
TCAATCTCATGACACT-1	ILC
TCAATCTGTGACAACG-1	Epithelial cells
TCAATCTTCAGTCATG-1	T cells
TCAATCTTCCTAGAGT-1	Macrophages
TCAATCTTCGCTGCGA-1	Monocytes
TCAATTCAGAGTGTTA-1	T cells
TCAATTCAGCGATGCA-1	Fibroblasts
TCAATTCAGGTTCATC-1	T cells
TCAATTCAGTAGACCG-1	Fibroblasts
TCAATTCCAAATGCTC-1	Monocytes
TCAATTCCACTAACCA-1	Fibroblasts
TCAATTCCAGCTAACT-1	Endothelial cells
TCAATTCCAGTGTACT-1	Fibroblasts
TCAATTCGTAGAATAC-1	T cells
TCAATTCGTCCAAATC-1	Fibroblasts
TCAATTCGTGTTCATG-1	Macrophages
TCAATTCTCCAAGGGA-1	T cells
TCAATTCTCTGACCCT-1	DC
TCACAAGAGGGCCTCT-1	T cells
TCACAAGAGTATAGGT-1	Fibroblasts
TCACAAGTCATTACTC-1	Fibroblasts
TCACAAGTCGATAACC-1	DC
TCACAAGTCTAGTGAC-1	T cells
TCACACCCATATACCG-1	Fibroblasts
TCACACCGTAGCTGTT-1	Epithelial cells
TCACACCGTGAACTAA-1	Epithelial cells
TCACACCGTTCTAAGC-1	T cells
TCACACCGTTTGCCGG-1	Macrophages
TCACACCTCTCCCTAG-1	pDC
TCACACCTCTGGTCAA-1	NK cells
TCACATTAGACCAACG-1	T cells
TCACATTCATCTAACG-1	Fibroblasts
TCACATTGTACAAAGT-1	T cells
TCACATTGTCACTTCC-1	Macrophages
TCACATTGTCGTATGT-1	T cells
TCACATTGTCTCTCCA-1	T cells
TCACATTTCGTTGTAG-1	Monocytes
TCACATTTCTCTGGTC-1	Fibroblasts
TCACGCTAGCACTCAT-1	pDC
TCACGCTAGCCTGGAA-1	Epithelial cells
TCACGCTCACTGCACG-1	B cells
TCACGCTGTAACACCT-1	DC
TCACGCTTCAACCGAT-1	T cells
TCACGGGAGAGGGTAA-1	Fibroblasts
TCACGGGCACAGAAGC-1	Fibroblasts
TCACGGGCATGTTCGA-1	T cells
TCACGGGGTCTTCAAG-1	T cells
TCACGGGGTTGTATGC-1	Fibroblasts
TCACGGGTCACCATGA-1	Epithelial cells
TCACGGGTCATGTCTT-1	T cells
TCACGGGTCCACTGGG-1	Epithelial cells
TCACGGGTCGCGCTGA-1	Epithelial cells
TCACTATCACCTGCGA-1	Fibroblasts
TCACTATGTCATGGCC-1	Fibroblasts
TCACTATTCAGCATTG-1	T cells
TCACTATTCCTAACAG-1	Fibroblasts
TCACTCGAGATGATTG-1	Fibroblasts
TCACTCGAGGCCTTGC-1	Epithelial cells
TCACTCGTCCTAGAGT-1	T cells
TCACTCGTCGGAAGGT-1	Epithelial cells
TCAGCAAAGAATCGCG-1	Epithelial cells
TCAGCAAAGATGTTCC-1	Fibroblasts
TCAGCAAAGCAGATAT-1	Monocytes
TCAGCAAAGCGTGAAC-1	T cells
TCAGCAACACTAACGT-1	T cells
TCAGCAAGTTGGTGTT-1	Fibroblasts
TCAGCAATCAGACCCG-1	Epithelial cells
TCAGCAATCCGATCGG-1	Epithelial cells
TCAGCCTAGAAGAGCA-1	Epithelial cells
TCAGCCTAGAATTGCA-1	T cells
TCAGCCTAGAGCATCG-1	T cells
TCAGCCTAGTGAGCCA-1	pDC
TCAGCCTCACTCGATA-1	Macrophages
TCAGCCTGTCCGATCG-1	Endothelial cells
TCAGCCTGTGTACATC-1	Fibroblasts
TCAGGGCAGCTGGTGA-1	T cells
TCAGGGCAGGTAAACT-1	Macrophages
TCAGGGCAGTGCAGCA-1	Macrophages
TCAGGGCAGTGGCAGT-1	Monocytes
TCAGGGCCAAATAAGC-1	T cells
TCAGGGCCAAGTATCC-1	Epithelial cells
TCAGGGCCACGTAGTT-1	Plasma cells
TCAGGGCCATCCTGTC-1	Macrophages
TCAGGGCGTACAGTCT-1	T cells
TCAGGGCGTACAGTTC-1	Endothelial cells
TCAGGGCGTACCGTCG-1	NK cells
TCAGGGCGTTGCATCA-1	T cells
TCAGGGCTCCACTTCG-1	B cells
TCAGGGCTCTCCACTG-1	Fibroblasts
TCAGGGCTCTGCTAGA-1	Fibroblasts
TCAGGGCTCTGTCGTC-1	T cells
TCAGGTAAGGCATCAG-1	T cells
TCAGGTACATTGGCAT-1	Monocytes
TCAGGTAGTCACTAGT-1	Fibroblasts
TCAGGTAGTGTTAGCT-1	pDC
TCAGGTATCTGCTGAA-1	DC
TCAGTCCAGGTCCCTG-1	NK cells
TCAGTCCAGGTCTTTG-1	T cells
TCAGTCCCATGACTGT-1	B cells
TCAGTCCGTATCGCTA-1	Monocytes
TCAGTCCGTTCTCTAT-1	Fibroblasts
TCAGTCCTCCGACGGT-1	Monocytes
TCAGTCCTCCTACCAC-1	Monocytes
TCAGTGAAGGTAGACC-1	Epithelial cells
TCAGTGAGTCGCAGTC-1	Epithelial cells
TCAGTGATCTGCTCTG-1	Monocytes
TCAGTTTAGAAGTGTT-1	Monocytes
TCAGTTTCACGTACAT-1	pDC
TCAGTTTGTAGTCTGT-1	Epithelial cells
TCAGTTTGTCTTCATT-1	Endothelial cells
TCAGTTTTCCTTCACG-1	T cells
TCATACTAGGTTTGAA-1	T cells
TCATACTGTCCTGTCT-1	T cells
TCATACTGTGCACGCT-1	Fibroblasts
TCATACTTCATGCTAG-1	Monocytes
TCATATCAGCTAAACA-1	T cells
TCATATCTCAGCATTG-1	Epithelial cells
TCATATCTCCGAGGCT-1	T cells
TCATATCTCGCCGAGT-1	T cells
TCATATCTCGCCTTTG-1	T cells
TCATATCTCGTCGCTT-1	Fibroblasts
TCATCATAGTGTACCT-1	Epithelial cells
TCATCATAGTTTGGCT-1	T cells
TCATCATCACGAGGAT-1	T cells
TCATCATCACGCCAGT-1	Fibroblasts
TCATCATGTAAGATCA-1	Fibroblasts
TCATCATGTGTTGATC-1	T cells
TCATCATTCCAAACCA-1	pDC
TCATCATTCCGTAGTA-1	T cells
TCATCCGAGACGCCAA-1	B cells
TCATCCGAGATGACCG-1	Fibroblasts
TCATCCGCAAGTATCC-1	Epithelial cells
TCATCCGCATGCACTA-1	Epithelial cells
TCATCCGGTTTAAGGA-1	DC
TCATCCGTCCTCACCA-1	NK cells
TCATGAGAGAAACCCG-1	DC
TCATGAGAGTAGGGTC-1	Fibroblasts
TCATGAGCAGGACTAG-1	Fibroblasts
TCATGAGGTGCGAGTA-1	Endothelial cells
TCATGAGGTTACCCTC-1	ILC
TCATGAGTCACCCTTG-1	Plasma cells
TCATGAGTCCGCTGTT-1	Epithelial cells
TCATGCCTCAGCCTTC-1	Fibroblasts
TCATGCCTCGCAAGAG-1	T cells
TCATGGAAGCATGTTC-1	Epithelial cells
TCATGGAAGTTCTCTT-1	Epithelial cells
TCATGGAAGTTGCGAG-1	T cells
TCATGGACAACCGACC-1	T cells
TCATGGACAAGTGCAG-1	T cells
TCATGGACAATTGCCA-1	ILC
TCATGGATCTGTCCCA-1	DC
TCATGTTAGACCCTTA-1	Fibroblasts
TCATGTTAGGTCCCTG-1	T cells
TCATGTTCAAGCAGGT-1	Endothelial cells
TCATGTTCACCTCAGG-1	Epithelial cells
TCATGTTGTGAGGATC-1	Epithelial cells
TCATTACAGTAGGCCA-1	Epithelial cells
TCATTACGTATCAGGG-1	T cells
TCATTACTCCCGAGTG-1	Monocytes
TCATTACTCGACGATT-1	Fibroblasts
TCATTCAAGACTTGTC-1	Monocytes
TCATTCAAGGCTAGCA-1	Fibroblasts
TCATTCAAGGTGCCAA-1	Mast cells
TCATTCAAGTTTGAGA-1	T cells
TCATTCACAGATTTCG-1	Epithelial cells
TCATTCATCACAAGAA-1	Monocytes
TCATTCATCCAATGCA-1	Epithelial cells
TCATTGTAGCATCCCG-1	Fibroblasts
TCATTGTAGGTACAGC-1	T cells
TCATTGTAGTAGTGCG-1	Fibroblasts
TCATTGTCAAGGTCGA-1	T cells
TCATTGTCACCTCAGG-1	T cells
TCATTGTTCCATCTCG-1	Fibroblasts
TCATTTGAGTAGTCAA-1	T cells
TCCACCAAGCGAACTG-1	Macrophages
TCCACCAAGTTGCGCC-1	Endothelial cells
TCCACCACACAAGCTT-1	T cells
TCCACCAGTGAGCCAA-1	Fibroblasts
TCCACCAGTTGGCTAT-1	DC
TCCACGTAGGCTAGCA-1	pDC
TCCACGTAGGCTCACC-1	Endothelial cells
TCCACGTGTGAGACCA-1	T cells
TCCACGTTCGACCAAT-1	Endothelial cells
TCCACGTTCTGTCCCA-1	T cells
TCCAGAAAGATTGGGC-1	Endothelial cells
TCCAGAAAGTCTAGAA-1	Monocytes
TCCAGAAGTGGATCAG-1	Monocytes
TCCAGAATCACTTTGT-1	T cells
TCCATCGAGATCGCTT-1	Macrophages
TCCATCGCAATCTCTT-1	Epithelial cells
TCCATCGGTAGCTCGC-1	T cells
TCCATCGGTCTTTATC-1	Macrophages
TCCATCGGTGTCACAT-1	T cells
TCCATCGGTTGTAGCT-1	Monocytes
TCCATCGTCCGCAAAT-1	T cells
TCCATCGTCTTCCTAA-1	Epithelial cells
TCCATGCAGTACTGGG-1	T cells
TCCATGCGTACGAGCA-1	Fibroblasts
TCCATGCGTTCTGAGT-1	Monocytes
TCCATGCTCAACCTCC-1	Macrophages
TCCATGCTCACCTACC-1	Macrophages
TCCATGCTCCGTTGAA-1	Monocytes
TCCATGCTCGTTGTGA-1	Epithelial cells
TCCCACAAGTGCCTCG-1	Macrophages
TCCCACACAAATACGA-1	T cells
TCCCACACAAGAGCTG-1	Monocytes
TCCCACACACTACACA-1	Fibroblasts
TCCCACACAGGTGGAT-1	Endothelial cells
TCCCACAGTGCCCAGT-1	T cells
TCCCACATCTCCCATG-1	T cells
TCCCAGTAGAGCAGAA-1	Fibroblasts
TCCCAGTAGCCTAACT-1	T cells
TCCCAGTAGGACTATA-1	Monocytes
TCCCAGTAGTCATCGT-1	Epithelial cells
TCCCAGTGTGGGTTGA-1	Fibroblasts
TCCCAGTTCGACCAAT-1	NK cells
TCCCAGTTCTTCGACC-1	T cells
TCCCATGAGTCTCGTA-1	Monocytes
TCCCATGCAGAGCGTA-1	DC
TCCCATGCATGGATCT-1	T cells
TCCCATGGTACGGATG-1	T cells
TCCCATGGTGTTTACG-1	T cells
TCCCATGTCAACGTGT-1	Monocytes
TCCCATGTCCCGGTAG-1	Endothelial cells
TCCCATGTCCGTCAAA-1	Fibroblasts
TCCGAAAAGACCAGCA-1	DC
TCCGAAAAGCTGAGTG-1	T cells
TCCGAAAAGGATCATA-1	T cells
TCCGAAAAGGTTCCAT-1	Fibroblasts
TCCGAAAAGTTCCAGT-1	Macrophages
TCCGAAACATAACCCA-1	Fibroblasts
TCCGAAACATAGATCC-1	Fibroblasts
TCCGAAAGTAGACGTG-1	Endothelial cells
TCCGAAAGTGATTCAC-1	Epithelial cells
TCCGAAAGTGCCGGTT-1	Fibroblasts
TCCGAAATCACCTGGG-1	DC
TCCGATCAGTAGTGCG-1	Epithelial cells
TCCGATCCACTCCTTG-1	Fibroblasts
TCCGATCCAGTCTGGC-1	T cells
TCCGATCGTCTGCGCA-1	T cells
TCCGATCTCTCATTTG-1	Endothelial cells
TCCGGGAAGCCAGTAG-1	Epithelial cells
TCCGGGAAGGAAGAAC-1	T cells
TCCGGGACAGAGGAAA-1	Monocytes
TCCGGGAGTCTACATG-1	Fibroblasts
TCCGGGAGTTTACTGG-1	Monocytes
TCCGGGAGTTTAGTCG-1	DC
TCCGTGTGTATCGCGC-1	B cells
TCCGTGTGTGTACGCC-1	Fibroblasts
TCCGTGTGTTACCCTC-1	Fibroblasts
TCCGTGTTCATTACGG-1	T cells
TCCTAATAGACACACG-1	Epithelial cells
TCCTAATAGGTAAAGG-1	Fibroblasts
TCCTAATCACAACGTT-1	T cells
TCCTAATCATGAGTAA-1	Epithelial cells
TCCTAATGTTTGGCTA-1	Epithelial cells
TCCTAATTCGGCCTTT-1	Fibroblasts
TCCTCCCAGGCCTTCG-1	Fibroblasts
TCCTCCCAGGGCCAAT-1	T cells
TCCTCCCAGTGCGTCC-1	Monocytes
TCCTCCCCACTCCACT-1	T cells
TCCTCCCCAGAGATGC-1	Monocytes
TCCTCCCTCAAACCCA-1	Epithelial cells
TCCTCCCTCACCTACC-1	Epithelial cells
TCCTCCCTCCTTATGT-1	T cells
TCCTCCCTCGCCAGTG-1	Fibroblasts
TCCTCCCTCGGCCTTT-1	pDC
TCCTCCCTCGGTCTAA-1	Fibroblasts
TCCTCCCTCTTGTTAC-1	T cells
TCCTCGAAGCGAGTCA-1	Fibroblasts
TCCTCGAAGTCGCCCA-1	T cells
TCCTCGACACACAGCC-1	T cells
TCCTCGACACCGAATT-1	Epithelial cells
TCCTCGATCTAACGGT-1	Epithelial cells
TCCTCGATCTTACTGT-1	B cells
TCCTCTTAGCAATAAC-1	Fibroblasts
TCCTCTTAGCACTGGA-1	Fibroblasts
TCCTCTTCAGTCAGAG-1	NK cells
TCCTCTTGTGATACAA-1	Fibroblasts
TCCTCTTGTGGACCTC-1	T cells
TCCTCTTGTTCGGACC-1	Fibroblasts
TCCTCTTGTTTGATCG-1	NK cells
TCCTGCAAGGCACTAG-1	Endothelial cells
TCCTGCACATACATCG-1	T cells
TCCTGCATCGAGATGG-1	T cells
TCCTGCATCTCTGACC-1	T cells
TCCTTCTCAACCGTGC-1	T cells
TCCTTCTCAGCGACCT-1	Endothelial cells
TCCTTCTCATCATGAC-1	Epithelial cells
TCCTTCTGTCACCGCA-1	Fibroblasts
TCCTTCTGTGACACGA-1	T cells
TCCTTCTGTTCACCGG-1	Epithelial cells
TCCTTCTTCCGAGCTG-1	Fibroblasts
TCCTTCTTCGCGTCGA-1	T cells
TCCTTCTTCTCATTTG-1	Monocytes
TCCTTTCCAGCAGTAG-1	Fibroblasts
TCCTTTCCAGCTCGGT-1	Monocytes
TCCTTTCGTAGATCCT-1	Fibroblasts
TCCTTTCGTCCAATCA-1	Fibroblasts
TCCTTTCGTTTACCAG-1	Epithelial cells
TCGAACAAGCCTAGGA-1	Fibroblasts
TCGAACAAGCCTCTCT-1	Monocytes
TCGAACAAGTTACGGG-1	Epithelial cells
TCGAACACAACTGAAA-1	T cells
TCGAACACAAGCCATT-1	Epithelial cells
TCGAACATCATTTGGG-1	Fibroblasts
TCGAAGTAGTAAATGC-1	Fibroblasts
TCGAAGTAGTTACGGG-1	Fibroblasts
TCGAAGTCACGTCATA-1	B cells
TCGAAGTCAGATCATC-1	Epithelial cells
TCGAAGTGTGACAGCA-1	T cells
TCGAAGTTCGTTCAGA-1	Fibroblasts
TCGACCTAGCTCTGTA-1	T cells
TCGACCTAGGGATCGT-1	T cells
TCGACCTCACACGCCA-1	Fibroblasts
TCGACCTTCAATCGGT-1	Monocytes
TCGACCTTCGAGTCCG-1	Fibroblasts
TCGACGGCAGCCATTA-1	Fibroblasts
TCGACGGCAGTGTGGA-1	Epithelial cells
TCGACGGGTGCCCAGT-1	B cells
TCGACGGTCACCCTCA-1	Fibroblasts
TCGACGGTCCAGTTCC-1	Epithelial cells
TCGACGGTCTGTGCGG-1	Fibroblasts
TCGATTTAGTGGCGAT-1	T cells
TCGATTTCAACCCTAA-1	T cells
TCGATTTGTCCCGGTA-1	Monocytes
TCGATTTGTCGGAACA-1	Endothelial cells
TCGATTTGTGCGAACA-1	T cells
TCGATTTTCACCCTCA-1	NK cells
TCGATTTTCCCTAGGG-1	Fibroblasts
TCGCACTCACATACGT-1	ILC
TCGCACTCACTGGCCA-1	Fibroblasts
TCGCACTCAGGTCAAG-1	Fibroblasts
TCGCACTCATTGAAAG-1	T cells
TCGCACTTCCGTATAG-1	Macrophages
TCGCAGGAGATGAACT-1	Fibroblasts
TCGCAGGAGCAGGCAT-1	T cells
TCGCAGGAGCTTGTTG-1	Macrophages
TCGCAGGAGTAAGCAT-1	Epithelial cells
TCGCAGGCAATGTCAC-1	Endothelial cells
TCGCAGGGTTCCGCAG-1	Fibroblasts
TCGCAGGGTTGTGCAT-1	T cells
TCGCTCACACCCAACG-1	Fibroblasts
TCGCTCACAGCTTTCC-1	T cells
TCGCTCAGTTACGGAG-1	Fibroblasts
TCGCTCATCGGATTAC-1	Monocytes
TCGCTTGAGAGGTCGT-1	Epithelial cells
TCGCTTGCAAGCGCAA-1	Fibroblasts
TCGCTTGCAGTCTCTC-1	Fibroblasts
TCGCTTGCATTGGGAG-1	Fibroblasts
TCGCTTGGTAGACTGG-1	T cells
TCGCTTGGTGAGCAGT-1	B cells
TCGCTTGGTTCTCCTG-1	T cells
TCGCTTGTCCAAGAGG-1	Fibroblasts
TCGCTTGTCGTTTACT-1	T cells
TCGGATAAGCCTCTCT-1	Macrophages
TCGGATAAGCTGACTT-1	T cells
TCGGATACACTCCGGA-1	T cells
TCGGATACAGGTGGAT-1	Epithelial cells
TCGGATAGTGTTCATG-1	Endothelial cells
TCGGATATCTCACTCG-1	Fibroblasts
TCGGATATCTCTAGGA-1	T cells
TCGGATATCTGTGCTC-1	T cells
TCGGATATCTTCTAAC-1	T cells
TCGGGACAGCATCGAG-1	T cells
TCGGGACTCAAGAGGC-1	Fibroblasts
TCGGGACTCCCTAGGG-1	Epithelial cells
TCGGGACTCCCTCGTA-1	DC
TCGGGACTCTACCTTA-1	T cells
TCGGGCAAGCCTGCCA-1	Epithelial cells
TCGGGCAGTATGACAA-1	T cells
TCGGGCAGTCACAATC-1	Fibroblasts
TCGGGCATCCTTGGAA-1	Epithelial cells
TCGGGTGAGCATCGAG-1	T cells
TCGGGTGAGCATTTGC-1	Macrophages
TCGGGTGGTCTAACGT-1	T cells
TCGGGTGTCATAAGGA-1	DC
TCGGTCTAGAGGATGA-1	Fibroblasts
TCGGTCTAGATAACGT-1	T cells
TCGGTCTAGCTTAGTC-1	Monocytes
TCGGTCTCAAACGGCA-1	Fibroblasts
TCGGTCTCACACTGGC-1	Epithelial cells
TCGGTCTCACATGGTT-1	Fibroblasts
TCGGTCTCAGATAAAC-1	Epithelial cells
TCGGTCTGTACCCAGC-1	Fibroblasts
TCGGTCTGTGCTTCAA-1	Epithelial cells
TCGGTCTGTTCTCCCA-1	Fibroblasts
TCGGTCTTCACTCTTA-1	T cells
TCGGTCTTCGAGATGG-1	Monocytes
TCGTAGAAGAACCCGA-1	Fibroblasts
TCGTAGAAGCCTGACC-1	Monocytes
TCGTAGAGTCACCGCA-1	DC
TCGTAGAGTCATAAAG-1	T cells
TCGTAGATCACTTGGA-1	Monocytes
TCGTAGATCCGCTTAC-1	T cells
TCGTCCAAGGAATTAC-1	T cells
TCGTCCAAGGTCGTAG-1	T cells
TCGTCCAGTCCAGCAC-1	Fibroblasts
TCGTCCATCGCTTGAA-1	Epithelial cells
TCGTCCATCTAGGCCG-1	Endothelial cells
TCGTGCTAGAAGAGCA-1	Fibroblasts
TCGTGCTAGGGTTTCT-1	T cells
TCGTGCTCAACACAAA-1	T cells
TCGTGCTGTTCCACGG-1	Endothelial cells
TCGTGGGAGTATAGAC-1	ILC
TCGTGGGCAAATCGTC-1	Fibroblasts
TCGTGGGGTCAACACT-1	Epithelial cells
TCGTGGGGTCCAATCA-1	Fibroblasts
TCGTGGGGTTGGGTTT-1	Fibroblasts
TCGTGGGTCATACAGC-1	T cells
TCGTGGGTCCGTGCGA-1	Fibroblasts
TCGTGGGTCTAAGCGT-1	T cells
TCTAACTCACATCATG-1	T cells
TCTAACTCACTAACGT-1	T cells
TCTAACTCAGTAGAAT-1	B cells
TCTAACTCATGCACTA-1	T cells
TCTAACTGTGATGAAT-1	Fibroblasts
TCTACATAGTTGGAGC-1	T cells
TCTACATCATTAGGCT-1	Monocytes
TCTACATGTCCAAATC-1	Fibroblasts
TCTACATTCGACCATA-1	Epithelial cells
TCTACCGAGCAACTCT-1	Endothelial cells
TCTACCGCAGCAGAAC-1	T cells
TCTACCGGTCGTCATA-1	T cells
TCTACCGGTGACCGTC-1	T cells
TCTACCGGTGGTATGG-1	T cells
TCTACCGGTTATCTGG-1	Fibroblasts
TCTACCGTCACCCATC-1	T cells
TCTACCGTCCGATGCG-1	Fibroblasts
TCTACCGTCGGCATCG-1	Epithelial cells
TCTACCGTCTGGTGCG-1	NK cells
TCTATACGTACAATAG-1	Fibroblasts
TCTATACGTACAGGTG-1	Macrophages
TCTATACTCAAGAGGC-1	ILC
TCTATACTCTACACAG-1	Epithelial cells
TCTATCAAGCAAATCA-1	NK cells
TCTATCAAGCTCCCTT-1	NK cells
TCTATCAAGTCCGTCG-1	Fibroblasts
TCTATCACACGCAGTC-1	Fibroblasts
TCTATCACATGGGAAC-1	Monocytes
TCTATCACATGTTACG-1	Fibroblasts
TCTATCAGTGTGTTTG-1	Epithelial cells
TCTATCATCCCAAGCG-1	T cells
TCTATCATCCCTAGGG-1	B cells
TCTATCATCTCGCCTA-1	T cells
TCTCACGAGGCGAAGG-1	T cells
TCTCACGAGGGAGTGG-1	pDC
TCTCACGAGTCCTGCG-1	T cells
TCTCACGGTAAGGTCG-1	B cells
TCTCACGGTACGTGTT-1	Fibroblasts
TCTCACGGTCGTACAT-1	NK cells
TCTCACGGTGTTTGCA-1	T cells
TCTCACGGTTATCTGG-1	Epithelial cells
TCTCACGGTTGACTGT-1	Fibroblasts
TCTCACGTCAGCAGAG-1	Macrophages
TCTCACGTCAGGAAGC-1	Macrophages
TCTCAGCAGATTACCC-1	T cells
TCTCAGCAGTATGGAT-1	T cells
TCTCAGCCACACGGTC-1	Fibroblasts
TCTCAGCCACCACTGG-1	Epithelial cells
TCTCAGCCATACTGAC-1	T cells
TCTCAGCGTAACGATA-1	Fibroblasts
TCTCAGCGTACCTATG-1	pDC
TCTCAGCGTCATCCGG-1	T cells
TCTCAGCGTCCCACGA-1	T cells
TCTCAGCGTGTGAATA-1	Macrophages
TCTCAGCGTTAGGAGC-1	T cells
TCTCCGACAATCGCGC-1	T cells
TCTCCGACACTCACTC-1	T cells
TCTCCGAGTACGGGAT-1	Epithelial cells
TCTCCGAGTCTTCATT-1	T cells
TCTCCGATCTGAATGC-1	Fibroblasts
TCTCTGGAGCAATTCC-1	T cells
TCTCTGGAGCGCCCAT-1	Epithelial cells
TCTCTGGAGGATCATA-1	Fibroblasts
TCTCTGGGTATGCGGA-1	Macrophages
TCTCTGGGTTGCAAGG-1	Endothelial cells
TCTCTGGTCATTTACC-1	T cells
TCTCTGGTCCCATAAG-1	Fibroblasts
TCTCTGGTCCGCAGTG-1	Monocytes
TCTGCCAAGAGCCATG-1	pDC
TCTGCCAAGCTCTATG-1	Macrophages
TCTGCCAAGGGATCAC-1	T cells
TCTGCCACATATGCGT-1	Epithelial cells
TCTGCCACATCATCTT-1	Fibroblasts
TCTGCCACATCCCACT-1	Epithelial cells
TCTGCCACATCGTGGC-1	B cells
TCTGCCAGTCCTCCAT-1	Epithelial cells
TCTGCCATCCCGAATA-1	Fibroblasts
TCTGGCTAGCACCGTC-1	T cells
TCTGGCTCAATCTGCA-1	Fibroblasts
TCTGGCTGTAAGGTCG-1	Fibroblasts
TCTGGCTGTAAGTTGA-1	Fibroblasts
TCTGGCTGTCCAATCA-1	T cells
TCTGGCTTCATTTCGT-1	DC
TCTGTCGAGGCAATGC-1	Epithelial cells
TCTGTCGAGGGATCGT-1	Fibroblasts
TCTGTCGAGTAGACAT-1	Fibroblasts
TCTGTCGAGTAGGCCA-1	Epithelial cells
TCTGTCGCAAATCGGG-1	Fibroblasts
TCTGTCGCAATTGCCA-1	Epithelial cells
TCTGTCGCATGACAGG-1	Epithelial cells
TCTGTCGGTTGTGGCC-1	Fibroblasts
TCTGTCGTCCGTGCGA-1	Fibroblasts
TCTTAGTAGATGCTTC-1	Endothelial cells
TCTTAGTAGCATACTC-1	Fibroblasts
TCTTAGTCAGCTGAAG-1	Monocytes
TCTTAGTCAGTCGGTC-1	Fibroblasts
TCTTAGTGTCAAGCGA-1	T cells
TCTTAGTGTCGGTGTC-1	Plasma cells
TCTTAGTGTGATAGTA-1	B cells
TCTTAGTGTGGTCTGC-1	Fibroblasts
TCTTAGTTCATTTGGG-1	Monocytes
TCTTAGTTCGAGCACC-1	Epithelial cells
TCTTCCTAGAAGCTGC-1	T cells
TCTTCCTAGACGCCAA-1	T cells
TCTTCCTAGATACTGA-1	Fibroblasts
TCTTCCTCAGACTCTA-1	T cells
TCTTCCTCAGTCAGTT-1	Fibroblasts
TCTTCCTTCAAACGAA-1	B cells
TCTTCCTTCGCAATTG-1	Fibroblasts
TCTTCCTTCTTGGGCG-1	Fibroblasts
TCTTGCGAGACTTAAG-1	Epithelial cells
TCTTGCGAGAGAATCT-1	T cells
TCTTGCGAGCTGACCC-1	Monocytes
TCTTGCGGTCAAATCC-1	Endothelial cells
TCTTGCGTCGCTCATC-1	Epithelial cells
TCTTTGAAGCGCTTCG-1	Fibroblasts
TCTTTGAAGTAAAGCT-1	Fibroblasts
TCTTTGACAACCAGAG-1	Endothelial cells
TCTTTGAGTGCCTAAT-1	Monocytes
TCTTTGATCAGAGCAG-1	Epithelial cells
TCTTTGATCTTGCGCT-1	Monocytes
TGAACGTCAGGACATG-1	T cells
TGAACGTGTATTAAGG-1	Epithelial cells
TGAACGTTCAGCTTGA-1	Fibroblasts
TGAACGTTCGTTCATT-1	Fibroblasts
TGAATCGAGACAAGCC-1	T cells
TGAATCGAGTAAGACT-1	Fibroblasts
TGAATCGGTGAAAGTT-1	Monocytes
TGAATCGGTTGGGCCT-1	Macrophages
TGAATGCAGACAACTA-1	Macrophages
TGAATGCAGACCAACG-1	Fibroblasts
TGAATGCAGACCTTTG-1	Monocytes
TGAATGCAGATCCAAA-1	T cells
TGAATGCAGCGATCGA-1	T cells
TGAATGCAGTAGTGCG-1	Fibroblasts
TGAATGCCAGCCTTCT-1	Fibroblasts
TGAATGCGTCCTGAAT-1	T cells
TGAATGCGTCGAGCTC-1	Fibroblasts
TGAATGCTCAAGTAAG-1	Epithelial cells
TGAATGCTCAGTCATG-1	Fibroblasts
TGACAGTAGCTGCCTG-1	T cells
TGACAGTCAAATGGTA-1	Fibroblasts
TGACAGTCACGGTAGA-1	Endothelial cells
TGACAGTCACTAACGT-1	Fibroblasts
TGACAGTCAGCGTATT-1	B cells
TGACAGTGTAATTGGA-1	Fibroblasts
TGACAGTGTCTACAGT-1	T cells
TGACAGTTCTCGCTCA-1	Epithelial cells
TGACCCTAGCGATTCT-1	Fibroblasts
TGACCCTCAGCCCAGT-1	Macrophages
TGACCCTTCATTTGTC-1	T cells
TGACCCTTCGCCTTTG-1	Epithelial cells
TGACCCTTCGGTTGTA-1	Fibroblasts
TGACCCTTCTTAATCC-1	T cells
TGACGCGAGCAATTCC-1	Epithelial cells
TGACGCGAGTCCTACA-1	Fibroblasts
TGACGCGAGTGATTCC-1	Macrophages
TGACGCGCAAATGCGG-1	Fibroblasts
TGACGCGCACTACGGC-1	Fibroblasts
TGACGCGCAGGTGACA-1	Endothelial cells
TGACGCGCATATCTCT-1	Epithelial cells
TGACGCGGTCCTGGTG-1	Fibroblasts
TGACGCGTCCGGACTG-1	Epithelial cells
TGACGCGTCCTAGCCT-1	Epithelial cells
TGACTCCAGCACTCCG-1	ILC
TGACTCCAGGCGTTAG-1	T cells
TGACTCCCAAAGGCAC-1	Macrophages
TGACTCCCAGGTTTAC-1	T cells
TGACTCCGTCGTGCCA-1	Epithelial cells
TGACTCCTCACGAGGA-1	Fibroblasts
TGACTCCTCCTACTGC-1	Epithelial cells
TGACTCCTCTTCTCAA-1	T cells
TGAGACTAGCCATGCC-1	Endothelial cells
TGAGACTAGCCTATCA-1	Fibroblasts
TGAGACTAGCGCGTTC-1	Epithelial cells
TGAGACTCACAAATGA-1	T cells
TGAGACTCAGTATTCG-1	T cells
TGAGACTCAGTTCTAG-1	Endothelial cells
TGAGACTCATAGGTTC-1	T cells
TGAGACTTCTGTCAGA-1	Epithelial cells
TGAGCATAGGAACGAA-1	T cells
TGAGCATAGTCTAACC-1	Epithelial cells
TGAGCATCACTAACGT-1	Fibroblasts
TGAGCATCAGAGTGAC-1	Fibroblasts
TGAGCATCATGACGGA-1	Macrophages
TGAGCATGTACTCAAC-1	Epithelial cells
TGAGCATGTCTCAGAT-1	T cells
TGAGCATGTGTCTTGA-1	T cells
TGAGCATTCAAAGGAT-1	Epithelial cells
TGAGCATTCGTCCATC-1	pDC
TGAGCATTCTATCCAT-1	Endothelial cells
TGAGCGCAGGATACCG-1	Fibroblasts
TGAGCGCGTCGAACAG-1	Monocytes
TGAGGAGAGCTAGATA-1	Monocytes
TGAGGAGGTAGGAGTC-1	Fibroblasts
TGAGGAGTCGCATAGT-1	Epithelial cells
TGAGGGAAGATCGACG-1	Macrophages
TGAGGGAAGCTGTTCA-1	Fibroblasts
TGAGGGACAACGGGTA-1	Fibroblasts
TGAGGGACAGAAACCG-1	Fibroblasts
TGAGGGATCTAATTCC-1	Fibroblasts
TGAGGTTAGCACGATG-1	Fibroblasts
TGAGGTTAGGCTAGCA-1	T cells
TGAGGTTGTCACGACC-1	Fibroblasts
TGAGGTTTCGCCGATG-1	T cells
TGAGTCAAGCCTATTG-1	Monocytes
TGAGTCAAGGGCATGT-1	Fibroblasts
TGAGTCACAACAAGTA-1	T cells
TGAGTCACATTGCCTC-1	T cells
TGAGTCAGTACCATAC-1	Monocytes
TGAGTCAGTAGACAAT-1	Fibroblasts
TGATCAGAGTACAGAT-1	Monocytes
TGATCAGCACTTCAGA-1	T cells
TGATCAGGTAAGCAAT-1	T cells
TGATCAGTCACCATCC-1	Fibroblasts
TGATCTTAGAGCAGTC-1	Epithelial cells
TGATCTTAGCGTGAAC-1	Fibroblasts
TGATCTTAGGAGTATT-1	Monocytes
TGATCTTAGGTTCTAC-1	Fibroblasts
TGATCTTCAAGCGCTC-1	NK cells
TGATCTTCACTTTAGG-1	T cells
TGATCTTGTGTGGACA-1	Macrophages
TGATCTTGTGTTCCAA-1	Endothelial cells
TGATCTTGTTTGCCGG-1	T cells
TGATCTTTCACAGTGT-1	Epithelial cells
TGATCTTTCAGCACCG-1	Fibroblasts
TGATGCACATGACGGA-1	Monocytes
TGATGCAGTTGGACTT-1	Macrophages
TGATGCATCTCCACTG-1	Fibroblasts
TGATGGTCAACACGTT-1	Plasma cells
TGATGGTGTGTGTTTG-1	Monocytes
TGATTCTAGAGAGTGA-1	Fibroblasts
TGATTCTAGGCGCTCT-1	T cells
TGATTCTAGTCGCGAA-1	Fibroblasts
TGATTCTCACAAATAG-1	Fibroblasts
TGATTCTCAGAATGTA-1	Endothelial cells
TGATTCTCAGGTATGG-1	Monocytes
TGATTCTGTACGGGAT-1	Epithelial cells
TGATTCTGTCGTACAT-1	Fibroblasts
TGATTCTGTTAAGTCC-1	T cells
TGATTTCAGCTCGAAG-1	T cells
TGATTTCAGGTCGAGT-1	Monocytes
TGATTTCCACAAGCTT-1	Epithelial cells
TGATTTCGTACGCTTA-1	T cells
TGATTTCGTAGAGGAA-1	T cells
TGCACGGAGATGCCGA-1	T cells
TGCACGGCAGCGACCT-1	T cells
TGCACGGCATGACGTT-1	Mast cells
TGCACGGGTCGAGCAA-1	Fibroblasts
TGCACGGTCAGAGTGG-1	Fibroblasts
TGCAGATAGATCGCTT-1	Fibroblasts
TGCAGATAGCGACATG-1	T cells
TGCAGATCAGTTGCGC-1	Fibroblasts
TGCAGATGTTCAAGGG-1	Fibroblasts
TGCAGATTCAAGCCGC-1	T cells
TGCAGATTCTATCGCC-1	Epithelial cells
TGCAGGCAGACCATTC-1	Epithelial cells
TGCAGGCAGTCATCGT-1	Epithelial cells
TGCAGGCAGTCTGCAT-1	T cells
TGCAGGCCAGGGAATC-1	T cells
TGCAGGCGTAGACTGG-1	pDC
TGCAGGCGTGGATTTC-1	Fibroblasts
TGCAGGCTCAACGTGT-1	T cells
TGCAGTAAGGTCGTGA-1	Fibroblasts
TGCAGTAAGGTGCGAT-1	Fibroblasts
TGCAGTACACAGAAGC-1	Fibroblasts
TGCAGTACACGTAACT-1	T cells
TGCAGTAGTGCTTCAA-1	Fibroblasts
TGCAGTATCACGGTCG-1	T cells
TGCATCCAGAAAGCGA-1	Fibroblasts
TGCATCCAGTATGATG-1	T cells
TGCATCCCACATGGTT-1	Mast cells
TGCATCCGTGCGTCGT-1	DC
TGCATCCTCACGGAGA-1	Plasma cells
TGCATGAAGGTTCCAT-1	T cells
TGCATGACAGGATCTT-1	Epithelial cells
TGCATGACATGACACT-1	T cells
TGCATGAGTCTAGATC-1	pDC
TGCATGATCGCCAACG-1	Fibroblasts
TGCATGATCTTTACAC-1	Epithelial cells
TGCCGAGAGCTTTCTT-1	Fibroblasts
TGCCGAGAGGGTTAGC-1	Fibroblasts
TGCCGAGAGTGAGGCT-1	Fibroblasts
TGCCGAGCACATACGT-1	Fibroblasts
TGCCGAGCACATATGC-1	T cells
TGCCGAGCACCCTTGT-1	Fibroblasts
TGCCGAGCAGGCACTC-1	B cells
TGCCGAGCAGGCTTGC-1	Monocytes
TGCCGAGGTCCCGGTA-1	T cells
TGCCGAGTCGGCAGTC-1	T cells
TGCCGAGTCTGGACCG-1	Epithelial cells
TGCGACGAGAGTGTTA-1	Epithelial cells
TGCGACGAGCAGCCTC-1	Monocytes
TGCGACGAGGATAATC-1	T cells
TGCGACGAGGCGAAGG-1	Endothelial cells
TGCGACGAGGGATGTC-1	T cells
TGCGACGGTACTCCCT-1	Fibroblasts
TGCGACGTCAAGCCTA-1	T cells
TGCGACGTCGTAGCCG-1	Fibroblasts
TGCGATAAGAGTGGCT-1	T cells
TGCGATAAGATCGCTT-1	Macrophages
TGCGATACAAAGCGTG-1	T cells
TGCGATACAATAGTGA-1	NK cells
TGCGATAGTCTGTGTA-1	Epithelial cells
TGCGATAGTGACGCCT-1	T cells
TGCGATAGTTAGTTCG-1	Fibroblasts
TGCGATATCACGATAC-1	T cells
TGCGATATCCTTCTGG-1	Endothelial cells
TGCGGCAAGGTAAGGA-1	Fibroblasts
TGCGGCAAGTATTGCC-1	T cells
TGCGGCAAGTTATGGA-1	Fibroblasts
TGCGGCACATAGATGA-1	DC
TGCGGCACATGTGCCG-1	T cells
TGCGGCAGTGAGACGT-1	Fibroblasts
TGCGGCATCTCCCATG-1	T cells
TGCGGGTAGATACTGA-1	T cells
TGCGGGTAGTTCCAGT-1	Macrophages
TGCGGGTCAACGATCT-1	Epithelial cells
TGCGGGTGTCCAGCGT-1	Epithelial cells
TGCGGGTGTGACAGGT-1	T cells
TGCGGGTTCGCAATTG-1	T cells
TGCTCCAAGGCTAAAT-1	Monocytes
TGCTCCAAGTCTTCCC-1	NK cells
TGCTCCACACTCCGAG-1	T cells
TGCTCCACAGCAGACA-1	Fibroblasts
TGCTCCAGTAGTCTGT-1	DC
TGCTCCATCCGCAAAT-1	Epithelial cells
TGCTCGTAGCAGCAGT-1	Fibroblasts
TGCTCGTCAATTGCCA-1	T cells
TGCTCGTTCAGCCCAG-1	T cells
TGCTGAAAGACAGTCG-1	Macrophages
TGCTGAAAGCTTCATG-1	Fibroblasts
TGCTGAAAGGAAGTCC-1	B cells
TGCTGAAAGGACAACC-1	Monocytes
TGCTGAACAGCGTAGA-1	Endothelial cells
TGCTGAAGTGTCCTAA-1	Fibroblasts
TGCTTCGAGCAGCGAT-1	Fibroblasts
TGCTTCGAGCGTCAAG-1	T cells
TGCTTCGAGGGCAGTT-1	T cells
TGCTTCGAGGTGCGAT-1	Macrophages
TGCTTCGCAAACTAGA-1	Epithelial cells
TGCTTCGCAACGCATT-1	Fibroblasts
TGCTTCGGTGGCCCAT-1	T cells
TGCTTCGTCCCGAGAC-1	T cells
TGCTTCGTCGATGCAT-1	Fibroblasts
TGCTTGCAGATGATTG-1	NK cells
TGCTTGCAGTTCCTGA-1	Monocytes
TGCTTGCCAAATGATG-1	Epithelial cells
TGCTTGCCATACTGTG-1	T cells
TGCTTGCGTTGGGAAC-1	DC
TGCTTGCGTTTGACAC-1	T cells
TGGAACTAGCGAGGAG-1	Endothelial cells
TGGAACTCACCCAACG-1	Fibroblasts
TGGAACTCACTACCCT-1	Epithelial cells
TGGAACTCACTCATAG-1	Fibroblasts
TGGAACTCAGGACAGT-1	Monocytes
TGGAACTGTAGTCTTG-1	T cells
TGGAACTGTTGAGTCT-1	Fibroblasts
TGGAACTTCATAAGGA-1	T cells
TGGAACTTCGACATTG-1	Endothelial cells
TGGAGAGAGAGACAAG-1	DC
TGGAGAGCAAACCACT-1	Fibroblasts
TGGAGAGCATTCCTAT-1	Fibroblasts
TGGAGAGGTCCACAGC-1	Fibroblasts
TGGAGAGTCGTACACA-1	Fibroblasts
TGGAGGAAGTTGGAGC-1	Epithelial cells
TGGAGGACATGCAGCC-1	Fibroblasts
TGGAGGAGTTGTAGCT-1	T cells
TGGAGGATCGGAGCAA-1	NK cells
TGGAGGATCTACGCGG-1	Monocytes
TGGATCAAGAACTGAT-1	T cells
TGGATCAAGTTCATGC-1	Epithelial cells
TGGATCAAGTTGCGCC-1	Epithelial cells
TGGATCACACCTCAGG-1	Epithelial cells
TGGATCACAGAACTAA-1	Epithelial cells
TGGATCACAGGAAGTC-1	Macrophages
TGGATCACAGTTTGGT-1	Monocytes
TGGATCAGTATATGGA-1	Epithelial cells
TGGATCAGTGATTGGG-1	T cells
TGGATGTAGGATACAT-1	Epithelial cells
TGGATGTCACTGATTG-1	T cells
TGGATGTGTGTATACC-1	T cells
TGGATGTTCAGACTGT-1	Fibroblasts
TGGATGTTCGGACTTA-1	T cells
TGGCGTGAGATTGAGT-1	Monocytes
TGGCGTGAGTCGCCAC-1	T cells
TGGCGTGCACTTCCTG-1	Epithelial cells
TGGCGTGCAGACACCC-1	NK cells
TGGCGTGGTCAATCTG-1	Epithelial cells
TGGCGTGGTGGCTTAT-1	pDC
TGGCGTGTCACCTGTC-1	Epithelial cells
TGGGAAGCACTGTTCC-1	Fibroblasts
TGGGAAGCAGGTCCCA-1	T cells
TGGGAAGGTTCCTTGC-1	T cells
TGGGAAGTCATCACCC-1	T cells
TGGGAAGTCGATGCAT-1	ILC
TGGGAAGTCTTGCAGA-1	T cells
TGGGAGAAGTCGAAAT-1	T cells
TGGGAGACAAGCGATG-1	Fibroblasts
TGGGAGACACGTTGGC-1	Macrophages
TGGGAGATCATCGCTC-1	Fibroblasts
TGGGAGATCATTACCT-1	T cells
TGGGAGATCCAAGGGA-1	Fibroblasts
TGGGAGATCGTGGACC-1	Fibroblasts
TGGGAGATCTGTACAG-1	Fibroblasts
TGGGAGATCTTCCACG-1	Fibroblasts
TGGGATTCAATATCCG-1	Epithelial cells
TGGGATTCACCTCTGT-1	B cells
TGGGATTCATGAAGCG-1	NK cells
TGGGATTGTCGAAACG-1	T cells
TGGGATTGTTACACAC-1	Fibroblasts
TGGGATTTCATCTATC-1	T cells
TGGGATTTCATGAAAG-1	Fibroblasts
TGGGATTTCCATCTAT-1	Epithelial cells
TGGGATTTCGGACGTC-1	Fibroblasts
TGGGCGTAGGAGTCTG-1	Epithelial cells
TGGGCGTAGTACAGCG-1	T cells
TGGGCGTCAACCGCTG-1	Fibroblasts
TGGGCGTCAAGTTCGT-1	Macrophages
TGGGCGTCATCCTTGC-1	Macrophages
TGGGCGTCATTCGATG-1	T cells
TGGGCGTTCCATCCGT-1	NK cells
TGGGCGTTCGTGAGAG-1	T cells
TGGGCTGAGGTAGACC-1	T cells
TGGGCTGAGTAACCTC-1	T cells
TGGGCTGCAGAGCTAG-1	T cells
TGGGCTGGTACCGCGT-1	Fibroblasts
TGGGCTGGTAGTGCGA-1	T cells
TGGGCTGTCAGTGTGT-1	Epithelial cells
TGGGCTGTCATTTGGG-1	Fibroblasts
TGGGCTGTCCAGTGCG-1	DC
TGGGTTAAGGGCAATC-1	T cells
TGGGTTACACCCTAGG-1	T cells
TGGGTTACACGCGCAT-1	Epithelial cells
TGGGTTACAGGGTTGA-1	ILC
TGGGTTAGTCCACTCT-1	Epithelial cells
TGGGTTAGTCGACGCT-1	Epithelial cells
TGGGTTATCAAATAGG-1	DC
TGGGTTATCAGTGATC-1	T cells
TGGGTTATCGGTATGT-1	Fibroblasts
TGGTACAAGGTGCTAG-1	T cells
TGGTACAGTACAAGCG-1	Epithelial cells
TGGTACAGTCCCTCAT-1	T cells
TGGTAGTAGAGACAAG-1	T cells
TGGTAGTAGTTGTAAG-1	Fibroblasts
TGGTAGTCAACAGAGC-1	Monocytes
TGGTAGTCACCAGTAT-1	Mast cells
TGGTAGTCACCTGTCT-1	Epithelial cells
TGGTAGTCAGTGTGGA-1	T cells
TGGTAGTGTAATGATG-1	Epithelial cells
TGGTAGTGTCTACAGT-1	Fibroblasts
TGGTAGTTCAAGCTGT-1	T cells
TGGTAGTTCCTCAGAA-1	Macrophages
TGGTGATGTGAGGATC-1	T cells
TGGTGATGTTGCCTAA-1	DC
TGGTGATTCACCACAA-1	Fibroblasts
TGGTGATTCCATTGCC-1	DC
TGGTTAGAGCTCGACC-1	Endothelial cells
TGGTTAGAGGCTCTCG-1	T cells
TGGTTAGCAAACTCGT-1	T cells
TGGTTAGCATGGCACC-1	Fibroblasts
TGGTTAGGTATCTCGA-1	Epithelial cells
TGGTTAGTCTAAGAAG-1	Endothelial cells
TGGTTAGTCTTGGAAC-1	Epithelial cells
TGGTTAGTCTTTCGAT-1	Epithelial cells
TGTAACGCACACCTGG-1	pDC
TGTAACGCAGGCACTC-1	B cells
TGTAACGGTAACAGTA-1	ILC
TGTAACGGTACCAATC-1	T cells
TGTAACGGTGACGTCC-1	Fibroblasts
TGTAACGGTGAGACGT-1	T cells
TGTAACGTCACTACTT-1	T cells
TGTAAGCAGAGGGTCT-1	Fibroblasts
TGTAAGCAGCTGCGAA-1	T cells
TGTAAGCAGGTACAGC-1	Endothelial cells
TGTAAGCAGTTTCTTC-1	Fibroblasts
TGTAAGCTCTAGTGTG-1	Fibroblasts
TGTAAGCTCTCAGTCC-1	Fibroblasts
TGTACAGAGTGGACTG-1	Epithelial cells
TGTACAGAGTGGCGAT-1	T cells
TGTACAGCAAGAGCTG-1	Epithelial cells
TGTACAGCAATCGAAA-1	Fibroblasts
TGTACAGCACCCAAGC-1	Monocytes
TGTACAGTCCGCAGTG-1	T cells
TGTACAGTCCTTTAGT-1	Fibroblasts
TGTAGACCATCTTTCA-1	DC
TGTAGACGTGAGAGGG-1	Epithelial cells
TGTCAGACATGTCTAG-1	Fibroblasts
TGTCAGACATTAAGCC-1	Fibroblasts
TGTCAGAGTATATGGA-1	Monocytes
TGTCAGAGTATGTCTG-1	T cells
TGTCAGAGTCCTTGTC-1	Fibroblasts
TGTCAGATCATACGGT-1	Monocytes
TGTCAGATCTATTGTC-1	Fibroblasts
TGTCCACAGCACCGTC-1	Monocytes
TGTCCACAGCGTCGAA-1	T cells
TGTCCACGTAGACAAT-1	Epithelial cells
TGTCCACTCTCCACTG-1	Fibroblasts
TGTCCCAAGTAACCGG-1	Epithelial cells
TGTCCCAAGTCCCGAC-1	Fibroblasts
TGTCCCACACACCTTC-1	Fibroblasts
TGTCCCACACTTCCTG-1	B cells
TGTCCCACATACTGAC-1	T cells
TGTCCCACATTCATCT-1	Endothelial cells
TGTCCCAGTCACGCTG-1	Fibroblasts
TGTCCCAGTGTCTCCT-1	Fibroblasts
TGTCCCATCGCAGTCG-1	Macrophages
TGTCCTGAGCATTGAA-1	Fibroblasts
TGTCCTGAGGCATGCA-1	ILC
TGTCCTGCATCGGAAG-1	DC
TGTCCTGGTATCAAGA-1	Epithelial cells
TGTCCTGGTCGCATCG-1	Epithelial cells
TGTGAGTAGCACCAGA-1	T cells
TGTGAGTTCATTATCC-1	T cells
TGTGAGTTCCGCACGA-1	Fibroblasts
TGTGATGAGCGCTGCT-1	Fibroblasts
TGTGATGAGGGACCAT-1	pDC
TGTGATGCAAGCGAAC-1	DC
TGTGATGCAGGATGAC-1	Monocytes
TGTGATGCATCACGGC-1	Fibroblasts
TGTGATGGTGTTGAGG-1	T cells
TGTGATGGTTAATGAG-1	Fibroblasts
TGTGATGTCCGATAGT-1	T cells
TGTGCGGAGCTAGAAT-1	Endothelial cells
TGTGCGGAGCTCTTCC-1	Fibroblasts
TGTGCGGAGGCGATAC-1	T cells
TGTGCGGAGTAGGGTC-1	Macrophages
TGTGCGGCACACCGAC-1	Fibroblasts
TGTGCGGCATGCGTGC-1	Macrophages
TGTGCGGGTAGTGGCA-1	T cells
TGTGCGGTCACTTATC-1	T cells
TGTGCGGTCCTGTTAT-1	T cells
TGTGCGGTCCTTTGAT-1	Epithelial cells
TGTGCGGTCTGACAGT-1	pDC
TGTGGCGAGGCACTCC-1	Fibroblasts
TGTGGCGCAACATACC-1	Monocytes
TGTGGCGCAGATTTCG-1	Epithelial cells
TGTGGCGGTGTGCTTA-1	Fibroblasts
TGTGTGAAGACCATTC-1	Fibroblasts
TGTGTGACAATTGTGC-1	T cells
TGTGTGACACCCTAAA-1	Epithelial cells
TGTGTGACAGACCAAG-1	T cells
TGTGTGAGTTATCTGG-1	pDC
TGTGTGAGTTGTACGT-1	T cells
TGTGTGATCTCATAGG-1	T cells
TGTTACTAGATGAATC-1	T cells
TGTTACTAGGGCAGAG-1	T cells
TGTTACTCACATGAAA-1	Fibroblasts
TGTTACTGTAGCACAG-1	ILC
TGTTACTGTGGTCTTA-1	Monocytes
TGTTACTTCGACCCAG-1	Monocytes
TGTTACTTCGATTGGT-1	T cells
TGTTCATAGATACTGA-1	Endothelial cells
TGTTCATAGGCTGTAG-1	NK cells
TGTTCATAGTGAGGTC-1	Epithelial cells
TGTTCATCAAGCAATA-1	Fibroblasts
TGTTCATCAGAAGCTG-1	Fibroblasts
TGTTCATCATCTATCT-1	Endothelial cells
TGTTCATGTCACGACC-1	Epithelial cells
TGTTCATGTCCGAAAG-1	Fibroblasts
TGTTCATGTGCTCGTG-1	Fibroblasts
TGTTCATGTTGGTAGG-1	T cells
TGTTCATGTTTCACTT-1	Fibroblasts
TGTTCATTCACGGGCT-1	Monocytes
TGTTCATTCATTGGTG-1	pDC
TGTTCCGAGAGAAGGT-1	Fibroblasts
TGTTCCGAGCACCCAC-1	pDC
TGTTCCGAGCCTATTG-1	Epithelial cells
TGTTCCGAGTTAGAAC-1	ILC
TGTTCCGCAGACACCC-1	Fibroblasts
TGTTCCGTCGTTACCC-1	T cells
TGTTCCGTCTTGCAGA-1	Endothelial cells
TGTTCTAAGTATTGCC-1	pDC
TGTTCTACATAACCCA-1	Monocytes
TGTTCTAGTAACTAAG-1	Monocytes
TGTTCTAGTACACGCC-1	T cells
TGTTCTAGTTCGGTTA-1	Epithelial cells
TGTTCTATCAACTGGT-1	pDC
TGTTGAGCAAACAGGC-1	pDC
TGTTGAGCAACCGTGC-1	Fibroblasts
TGTTGAGGTCATGCAT-1	T cells
TGTTGAGTCATCGACA-1	Fibroblasts
TGTTGAGTCCATGATG-1	Fibroblasts
TGTTGAGTCTGTAAGC-1	T cells
TGTTGGACAATAAGGT-1	DC
TGTTGGAGTAATCAGA-1	Fibroblasts
TGTTGGAGTCCGCAGT-1	Plasma cells
TGTTTGTCACAGTACT-1	Fibroblasts
TGTTTGTCAGTGGCTC-1	T cells
TGTTTGTGTCACTTAG-1	Endothelial cells
TGTTTGTGTCGAGCTC-1	T cells
TGTTTGTGTTGCGGAA-1	Epithelial cells
TGTTTGTTCAGAGTGG-1	Epithelial cells
TGTTTGTTCCTAGCGG-1	Monocytes
TGTTTGTTCGAGCCTG-1	Fibroblasts
TTAATCCAGACGTCGA-1	Epithelial cells
TTAATCCAGTCTCTGA-1	Epithelial cells
TTAATCCCACGGTCTG-1	T cells
TTAATCCGTCACGCTG-1	T cells
TTAATCCGTTCGTGCG-1	Monocytes
TTAATCCTCGTTCTGC-1	Endothelial cells
TTAATCCTCTCACCCA-1	Fibroblasts
TTACAGGAGAGGTCGT-1	Fibroblasts
TTACAGGGTGAGCGAT-1	T cells
TTACCATCACGCGCTA-1	Epithelial cells
TTACCATGTCTACAAC-1	B cells
TTACCATGTTGCCATA-1	T cells
TTACCATTCCACGTCT-1	Fibroblasts
TTACCATTCCATAGAC-1	T cells
TTACCGCAGACCAACG-1	Epithelial cells
TTACCGCAGCTGCCTG-1	Fibroblasts
TTACCGCCACGACCTG-1	B cells
TTACCGCCAGACCATT-1	T cells
TTACCGCGTAGAGGAA-1	DC
TTACCGCGTTTACTTC-1	ILC
TTACCGCTCCGACAGC-1	Fibroblasts
TTACCGCTCCTAGCGG-1	Epithelial cells
TTACCGCTCGGACTGC-1	Fibroblasts
TTACCGCTCTCTTGCG-1	Epithelial cells
TTACCGCTCTGTAAGC-1	T cells
TTACCGCTCTTGCAGA-1	Fibroblasts
TTACGCCAGAAACCAT-1	T cells
TTACGCCAGCCGATTT-1	Endothelial cells
TTACGCCGTCCCACGA-1	Epithelial cells
TTACGCCGTCGACTGC-1	Fibroblasts
TTACGCCTCCGTAGTA-1	Epithelial cells
TTACGCCTCTCGTGAA-1	T cells
TTACGCCTCTTACGGA-1	pDC
TTACGTTAGATTGATG-1	Fibroblasts
TTACGTTAGTTGCGCC-1	Epithelial cells
TTACGTTCATTCACCC-1	T cells
TTACGTTGTAGACTGG-1	DC
TTACGTTGTTTGTTGG-1	T cells
TTACGTTTCTCGACGG-1	Endothelial cells
TTACTGTAGGGAACAA-1	Endothelial cells
TTACTGTCACTTGTGA-1	Macrophages
TTAGGCAAGGTTCTAC-1	T cells
TTAGGCAAGTCAGAGC-1	T cells
TTAGGCACAACGACTT-1	NK cells
TTAGGCACATAAGCAA-1	Fibroblasts
TTAGGCAGTAACCCGC-1	Fibroblasts
TTAGGCAGTAATCAAG-1	Epithelial cells
TTAGGCATCGAGTGAG-1	Epithelial cells
TTAGGGTCACACCTTC-1	Fibroblasts
TTAGGGTTCGGCTGAC-1	Epithelial cells
TTAGGGTTCTGACAGT-1	T cells
TTAGTCTAGGAGACCT-1	T cells
TTAGTCTAGTTAACAG-1	Fibroblasts
TTAGTCTCAACAGTGG-1	Fibroblasts
TTAGTCTCAAGGAGTC-1	T cells
TTAGTCTCAAGTGGAC-1	T cells
TTAGTCTCAATACGAA-1	T cells
TTAGTCTCAATTGAGA-1	Fibroblasts
TTAGTCTCACCACTGG-1	Fibroblasts
TTAGTCTCATAGATCC-1	B cells
TTAGTCTTCTTGGCTC-1	Monocytes
TTATTGCAGTCGAAGC-1	T cells
TTATTGCCACGGCACT-1	Epithelial cells
TTATTGCCAGTCTTCC-1	Epithelial cells
TTATTGCGTAACATAG-1	Fibroblasts
TTATTGCGTAGGACTG-1	Monocytes
TTATTGCTCCCAGGCA-1	B cells
TTATTGCTCTCAGGCG-1	Fibroblasts
TTCAATCCAGGCTTGC-1	T cells
TTCACCGAGTAAGAGG-1	Epithelial cells
TTCACCGAGTTTGAGA-1	Epithelial cells
TTCACCGCAACTCCAA-1	Epithelial cells
TTCACCGCACCATATG-1	Epithelial cells
TTCACCGCACCGAATT-1	Monocytes
TTCACCGCACCTCTAC-1	T cells
TTCACCGGTCCACACG-1	Fibroblasts
TTCACCGGTCGGCTAC-1	T cells
TTCACCGTCCATGCAA-1	B cells
TTCACCGTCCGTGACG-1	T cells
TTCACGCAGACATAAC-1	T cells
TTCACGCAGCTTTCCC-1	Fibroblasts
TTCACGCCATGCAGCC-1	Endothelial cells
TTCACGCTCCGCCTAT-1	Fibroblasts
TTCACGCTCGCGAAGA-1	T cells
TTCACGCTCTATTCGT-1	Epithelial cells
TTCACGCTCTCATTAC-1	Epithelial cells
TTCAGGACAAGCCATT-1	Epithelial cells
TTCAGGACATGAATCC-1	T cells
TTCAGGATCGCGTCGA-1	Epithelial cells
TTCAGGATCGTGCATA-1	Epithelial cells
TTCAGGATCTCCGCAT-1	Endothelial cells
TTCAGGATCTCGAACA-1	T cells
TTCATGTAGACCATGG-1	Monocytes
TTCATGTAGCTTTGTG-1	T cells
TTCATGTAGGTTATAG-1	Fibroblasts
TTCATGTCAAATACGA-1	Epithelial cells
TTCATGTCATAACAGA-1	Fibroblasts
TTCATGTCATGAGGGT-1	Fibroblasts
TTCATGTGTAGTGCGA-1	T cells
TTCATGTGTCAGTTTG-1	T cells
TTCATGTGTTGCATGT-1	Fibroblasts
TTCATGTTCAGGAAAT-1	Fibroblasts
TTCATGTTCGCGAAGA-1	T cells
TTCATGTTCGGCCTTT-1	Fibroblasts
TTCATTGAGGAAACGA-1	Epithelial cells
TTCATTGCACTGCATA-1	NK cells
TTCATTGGTAGTCACT-1	Fibroblasts
TTCATTGGTCAAGCGA-1	T cells
TTCATTGGTTCAACGT-1	T cells
TTCCAATAGCGATCGA-1	T cells
TTCCAATCATTGACCA-1	Monocytes
TTCCAATGTAAGGTCG-1	Fibroblasts
TTCCAATGTGTGGACA-1	T cells
TTCCAATTCTACTTCA-1	Fibroblasts
TTCCAATTCTCTGCCA-1	T cells
TTCCACGAGAGCCGAT-1	T cells
TTCCACGCACGGTCTG-1	Monocytes
TTCCACGCATGCGGTC-1	Fibroblasts
TTCCACGGTAACGATA-1	T cells
TTCCACGGTAGCGCTC-1	Fibroblasts
TTCCACGGTAGTTAGA-1	Fibroblasts
TTCCACGTCCACCTGT-1	Epithelial cells
TTCCACGTCCGTGGCA-1	T cells
TTCCGGTCAAACCATC-1	T cells
TTCCGGTGTACTGCCG-1	Epithelial cells
TTCCGGTGTGGCAACA-1	Endothelial cells
TTCCGGTGTGTCTCCT-1	Fibroblasts
TTCCGGTGTTAGAAGT-1	Fibroblasts
TTCCGGTTCAATGTCG-1	Macrophages
TTCCGGTTCATTTCGT-1	T cells
TTCCGTGAGACGCATG-1	B cells
TTCCGTGAGCCGTAAG-1	Endothelial cells
TTCCGTGAGGAGAGGC-1	T cells
TTCCGTGAGGGAGGGT-1	T cells
TTCCGTGCAAAGACTA-1	T cells
TTCCGTGCACACCTAA-1	Fibroblasts
TTCCGTGCACGATTCA-1	T cells
TTCCGTGGTATACAGA-1	DC
TTCCGTGTCCTCTAGC-1	Macrophages
TTCCTAAAGAGGTTTA-1	Fibroblasts
TTCCTAACAATCGCAT-1	Fibroblasts
TTCCTAACAGCTCATA-1	Fibroblasts
TTCCTAAGTGTAGCAG-1	T cells
TTCCTAATCAAACCCA-1	T cells
TTCCTAATCTAGCAAC-1	Fibroblasts
TTCCTCTAGACTCCGC-1	Epithelial cells
TTCCTCTAGCAACTTC-1	Fibroblasts
TTCCTCTAGCAGGTCA-1	Monocytes
TTCCTCTCAAATAGCA-1	Endothelial cells
TTCCTCTCACCAGCCA-1	T cells
TTCCTCTCACGTAGTT-1	T cells
TTCCTCTCACTAGGTT-1	Fibroblasts
TTCCTCTCAGACCTAT-1	T cells
TTCCTCTGTAAGTAGT-1	T cells
TTCCTCTGTAGTCTTG-1	Fibroblasts
TTCCTCTTCTGGACCG-1	DC
TTCCTTCAGAGGTCAC-1	Fibroblasts
TTCCTTCCAAGACCGA-1	T cells
TTCCTTCCACTCCACT-1	pDC
TTCCTTCCATCCTGTC-1	T cells
TTCCTTCGTAGGCAAC-1	Epithelial cells
TTCCTTCGTAGGTACG-1	T cells
TTCCTTCGTGCCTGCA-1	T cells
TTCCTTCGTTCCTAGA-1	T cells
TTCCTTCTCCGCAAAT-1	Epithelial cells
TTCGATTAGTGAGTTA-1	T cells
TTCGATTCAGCCGGTT-1	T cells
TTCGATTTCCAAGGGA-1	T cells
TTCGCTGAGGATTTAG-1	Epithelial cells
TTCGCTGAGTGAGTGC-1	T cells
TTCGCTGCACGTCTCT-1	T cells
TTCGCTGGTACGACAG-1	Fibroblasts
TTCGCTGGTCCGGATC-1	Fibroblasts
TTCGCTGGTCTCACGG-1	Fibroblasts
TTCGGTCAGGTACCTT-1	pDC
TTCGGTCAGTAGCTCT-1	Monocytes
TTCGGTCGTGGTTTGT-1	Fibroblasts
TTCGGTCTCAATCTTC-1	Fibroblasts
TTCGGTCTCACGACTA-1	T cells
TTCGGTCTCCAGGACC-1	Fibroblasts
TTCTAACAGACTGAGC-1	DC
TTCTAACAGTCGGGAT-1	T cells
TTCTAACCAGCAGGAT-1	Fibroblasts
TTCTAACCATCCGAAT-1	T cells
TTCTAACCATCGATCA-1	Fibroblasts
TTCTAACGTACCATAC-1	Plasma cells
TTCTAACGTAGATCCT-1	Epithelial cells
TTCTAACGTCATCAGT-1	Fibroblasts
TTCTAACGTCTACTGA-1	T cells
TTCTAACGTTCAAGGG-1	Epithelial cells
TTCTAGTAGAGAGGTA-1	T cells
TTCTAGTAGCAATTCC-1	Monocytes
TTCTAGTAGGATTTAG-1	Fibroblasts
TTCTAGTCACCAGTTA-1	Epithelial cells
TTCTAGTCAGGTATGG-1	Epithelial cells
TTCTAGTCATGGCTAT-1	Monocytes
TTCTAGTGTCGGATTT-1	T cells
TTCTAGTGTTTGGCTA-1	T cells
TTCTCTCAGTGCAGCA-1	T cells
TTCTCTCCATGCGGTC-1	Epithelial cells
TTCTCTCGTACGTACT-1	DC
TTCTCTCGTCTGTGTA-1	Fibroblasts
TTCTCTCTCGTCCTTG-1	T cells
TTCTGTAAGACGACTG-1	Fibroblasts
TTCTGTAAGTAAAGCT-1	Epithelial cells
TTCTGTACAACCGTGC-1	Fibroblasts
TTCTGTAGTCCACGCA-1	Macrophages
TTCTTCCAGAATCTAG-1	Fibroblasts
TTCTTCCAGTCCTACA-1	T cells
TTCTTCCAGTGGACGT-1	Monocytes
TTCTTCCCAACAGCTT-1	Monocytes
TTCTTCCCACATAGCT-1	Monocytes
TTCTTCCGTCCATCTC-1	DC
TTCTTCCTCAAGCCTA-1	Fibroblasts
TTCTTCCTCTGGGTCG-1	T cells
TTCTTGAAGATGACAT-1	Fibroblasts
TTCTTGAGTACCCGCA-1	Monocytes
TTCTTGAGTCCGAAAG-1	T cells
TTCTTGAGTCTCTCAC-1	Macrophages
TTCTTGAGTTATTCTC-1	Fibroblasts
TTCTTGATCCATAAGC-1	T cells
TTGAACGAGATTGAGT-1	Macrophages
TTGAACGAGGATTACA-1	Fibroblasts
TTGAACGAGGTTAGTA-1	Macrophages
TTGAACGGTAGGACCA-1	Epithelial cells
TTGAACGGTGGCACTC-1	T cells
TTGAACGTCACATCAG-1	T cells
TTGAACGTCATTGCGA-1	Epithelial cells
TTGAACGTCATTTACC-1	T cells
TTGAACGTCTAGCCTC-1	Fibroblasts
TTGACCCAGCCAAGCA-1	NK cells
TTGACCCCACTAACCA-1	Epithelial cells
TTGACCCGTCTGGTTA-1	Macrophages
TTGACCCGTCTGTGAT-1	NK cells
TTGACCCGTGACGTCC-1	Plasma cells
TTGACCCGTTCGGTTA-1	Fibroblasts
TTGACCCTCATTTCGT-1	Fibroblasts
TTGAGTGAGCACCGTC-1	Monocytes
TTGAGTGAGGCCTAAG-1	Fibroblasts
TTGAGTGCAACCAATC-1	T cells
TTGAGTGGTCCACACG-1	Fibroblasts
TTGAGTGGTGGTCCGT-1	Fibroblasts
TTGAGTGTCGTGAGAG-1	Monocytes
TTGATGGAGATGGTCG-1	T cells
TTGATGGAGCCAAGGT-1	T cells
TTGATGGAGCCAGAGT-1	Fibroblasts
TTGATGGGTCAGGAGT-1	Fibroblasts
TTGATGGGTGAGCAGT-1	Endothelial cells
TTGATGGTCAGCTGTA-1	T cells
TTGCATTAGATAGTCA-1	T cells
TTGCATTAGGCATTTC-1	DC
TTGCATTCAGGAGACT-1	Fibroblasts
TTGCATTTCAAACGTC-1	Fibroblasts
TTGCATTTCGAGTGGA-1	B cells
TTGCCTGAGGGCAATC-1	Fibroblasts
TTGCCTGCACTTGACA-1	Fibroblasts
TTGCCTGCATGCTGCG-1	Epithelial cells
TTGCCTGGTTGCAACT-1	Epithelial cells
TTGCGTCAGGACGGAG-1	B cells
TTGCGTCAGGTTGGAC-1	T cells
TTGCGTCCAAGCTGCC-1	Fibroblasts
TTGCGTCTCGACATTG-1	Fibroblasts
TTGCGTCTCGTCGCTT-1	Fibroblasts
TTGCTGCAGAGTTGAT-1	DC
TTGCTGCCACTTCCTG-1	T cells
TTGCTGCCAGATTCGT-1	pDC
TTGCTGCGTCATGGCC-1	Monocytes
TTGCTGCTCTCTTGCG-1	Fibroblasts
TTGGATGAGGATGCGT-1	T cells
TTGGATGAGGGATGTC-1	Monocytes
TTGGATGAGTAAGCAT-1	DC
TTGGATGAGTCCTGCG-1	Fibroblasts
TTGGATGGTAAGGCTG-1	Fibroblasts
TTGGATGGTCCATCTC-1	Monocytes
TTGGGATAGCACACAG-1	Fibroblasts
TTGGGATAGCCATTGT-1	Fibroblasts
TTGGGATAGGATATGT-1	Fibroblasts
TTGGGATAGGTCATAA-1	T cells
TTGGGCGAGAACGTGC-1	Fibroblasts
TTGGGCGAGTCGCGAA-1	T cells
TTGGGCGCAAAGAGTT-1	Fibroblasts
TTGGGCGCACCTCAGG-1	Fibroblasts
TTGGGCGGTAGTATAG-1	T cells
TTGGGCGGTGTACAGG-1	Fibroblasts
TTGGGCGGTGTGAGCA-1	Fibroblasts
TTGGGTAAGACCCGCT-1	NK cells
TTGGGTAAGCCTTGAT-1	Monocytes
TTGGGTACACACGGAA-1	T cells
TTGGGTACAGCTAACT-1	T cells
TTGGGTATCGTAACAC-1	Fibroblasts
TTGGTTTAGAGCAGTC-1	Endothelial cells
TTGGTTTGTGTGTCGC-1	NK cells
TTGGTTTTCCACCTCA-1	Fibroblasts
TTGTGGAAGACCGCCT-1	Fibroblasts
TTGTGGAAGCCTAACT-1	T cells
TTGTGGACAAAGTGTA-1	T cells
TTGTGGACAGACCAGA-1	T cells
TTGTGGACAGGGTTGA-1	Monocytes
TTGTGGATCCTCGCAT-1	Epithelial cells
TTGTGGATCGCTTAAG-1	Epithelial cells
TTGTGTTAGGAAGTGA-1	Fibroblasts
TTGTGTTAGGTGATAT-1	T cells
TTGTGTTCACCCGTAG-1	Fibroblasts
TTGTGTTGTCTCACAA-1	B cells
TTGTGTTGTGGCCACT-1	DC
TTGTGTTGTTTAGACC-1	Fibroblasts
TTGTGTTTCTGCTAGA-1	pDC
TTGTTCAAGAACAAGG-1	Epithelial cells
TTGTTCAAGCACAAAT-1	Epithelial cells
TTGTTCAAGGATGAGA-1	T cells
TTGTTCACAAACGGCA-1	Epithelial cells
TTGTTCACAGTCGAGA-1	T cells
TTGTTCAGTCGAATGG-1	Fibroblasts
TTGTTCATCACTTTGT-1	B cells
TTGTTCATCAGAGTGG-1	T cells
TTGTTGTAGCGTGTTT-1	Fibroblasts
TTGTTGTCACAGCGCT-1	Epithelial cells
TTGTTGTCAGTTACCA-1	Epithelial cells
TTGTTGTGTATCTCGA-1	T cells
TTGTTGTGTGGCGTAA-1	T cells
TTGTTGTGTTCTCACC-1	NK cells
TTGTTTGAGGAGGTTC-1	T cells
TTGTTTGGTTAATGAG-1	Epithelial cells
TTGTTTGGTTTCCCAC-1	Fibroblasts
TTGTTTGTCAAGCGTT-1	Epithelial cells
TTGTTTGTCCAGTGCG-1	Endothelial cells
TTTACCAAGAGCTGCA-1	T cells
TTTACCAAGCTACAAA-1	T cells
TTTACCACACACGCCA-1	Fibroblasts
TTTACCACAGAAGCTG-1	T cells
TTTACCAGTTAGAGAT-1	T cells
TTTACCAGTTGCAACT-1	Epithelial cells
TTTACCATCACCCATC-1	T cells
TTTACCATCAGTGTGT-1	Monocytes
TTTACGTAGACGGATC-1	Fibroblasts
TTTACGTCAAGTGGGT-1	Fibroblasts
TTTACGTCACAGCTTA-1	pDC
TTTACGTCATGGGTTT-1	T cells
TTTACGTGTCATAGTC-1	T cells
TTTACGTGTCGGTGTC-1	T cells
TTTACGTGTGGATGAC-1	Monocytes
TTTACGTTCTAGTGAC-1	T cells
TTTACGTTCTGCGTCT-1	Epithelial cells
TTTACTGAGATTAGTG-1	Plasma cells
TTTACTGAGGTGAGAA-1	T cells
TTTACTGGTACCAGAG-1	Epithelial cells
TTTACTGGTACTGCGC-1	Fibroblasts
TTTACTGGTCCTCCAT-1	T cells
TTTACTGGTCTTTATC-1	Fibroblasts
TTTACTGTCCGCACTT-1	Endothelial cells
TTTACTGTCTAATTCC-1	Monocytes
TTTAGTCAGAGCTTTC-1	Epithelial cells
TTTAGTCAGATCACCT-1	T cells
TTTAGTCAGGAGATAG-1	Epithelial cells
TTTAGTCCATAAGATG-1	Endothelial cells
TTTAGTCGTCAATCTG-1	pDC
TTTAGTCGTCTTTCTA-1	NK cells
TTTAGTCTCACCTCGT-1	T cells
TTTAGTCTCCATACAG-1	Fibroblasts
TTTAGTCTCGAATCCA-1	Monocytes
TTTATGCAGGAACGAA-1	ILC
TTTATGCAGTCGCCAC-1	Monocytes
TTTATGCAGTTACGTC-1	T cells
TTTATGCCAGTTGAAA-1	Endothelial cells
TTTATGCCATACCGTA-1	Fibroblasts
TTTATGCGTTGGCCTG-1	Macrophages
TTTATGCGTTGGTACT-1	Fibroblasts
TTTCACAAGAAGCGCT-1	Epithelial cells
TTTCACAAGTAACCTC-1	T cells
TTTCACACACGGGTAA-1	Monocytes
TTTCACACATCGGAAG-1	Fibroblasts
TTTCACAGTCCATAGT-1	T cells
TTTCAGTAGGCCGCTT-1	Fibroblasts
TTTCAGTAGGTGCATG-1	Endothelial cells
TTTCAGTGTGGCTGCT-1	T cells
TTTCAGTTCGAAGGAC-1	Endothelial cells
TTTCAGTTCGTTAGAC-1	Fibroblasts
TTTCATGAGATCCCAT-1	T cells
TTTCATGAGTAGATCA-1	Fibroblasts
TTTCATGCACCCAAGC-1	Endothelial cells
TTTCATGCACGCGGTT-1	B cells
TTTCATGCACGCTTAA-1	Macrophages
TTTCATGCACGTCTCT-1	Epithelial cells
TTTCATGGTCCTATAG-1	Fibroblasts
TTTCATGTCCGCGAGT-1	Fibroblasts
TTTCCTCAGACGTCCC-1	Fibroblasts
TTTCCTCAGAGGGCGA-1	Epithelial cells
TTTCCTCAGGCCTGCT-1	Epithelial cells
TTTCCTCCAACCGATT-1	Fibroblasts
TTTCCTCCAGCAATTC-1	B cells
TTTCCTCGTCACTTCC-1	T cells
TTTCGATAGCTGGTGA-1	T cells
TTTCGATCAGGTCCCA-1	NK cells
TTTCGATGTCGCTTAA-1	Endothelial cells
TTTCGATGTGTCCAAT-1	Epithelial cells
TTTCGATGTGTTTCTT-1	T cells
TTTGACTAGGATACAT-1	T cells
TTTGACTGTACTCGCG-1	Macrophages
TTTGACTGTGCCTATA-1	Macrophages
TTTGACTTCAGTGGGA-1	pDC
TTTGATCAGTGCACAG-1	Fibroblasts
TTTGATCCATATACCG-1	T cells
TTTGATCCATTGACCA-1	T cells
TTTGATCGTGGATTTC-1	Macrophages
TTTGGAGAGGATCATA-1	Fibroblasts
TTTGGAGCAGCTTTGA-1	Endothelial cells
TTTGGAGGTCTTACTT-1	T cells
TTTGGAGGTGCAACAG-1	pDC
TTTGGAGGTGGTAACG-1	pDC
TTTGGAGTCCATATGG-1	T cells
TTTGGAGTCCCATTTA-1	Fibroblasts
TTTGGAGTCCCTAGGG-1	Fibroblasts
TTTGGAGTCCGCGGAT-1	Fibroblasts
TTTGGAGTCCGTTTCG-1	T cells
TTTGGTTAGATCACCT-1	Epithelial cells
TTTGGTTAGCAGGCTA-1	Fibroblasts
TTTGGTTCAGGACAGT-1	ILC
TTTGGTTCATATGCGT-1	Monocytes
TTTGGTTTCATTGTTC-1	T cells
TTTGGTTTCTCATAGG-1	T cells
TTTGTTGAGCAACAGC-1	Fibroblasts
TTTGTTGCACCATTCC-1	Fibroblasts
TTTGTTGCAGAATGTA-1	T cells
TTTGTTGCAGGTCAAG-1	B cells
TTTGTTGGTTGTCAGT-1	pDC
TTTGTTGTCAATCCGA-1	Epithelial cells
TTTGTTGTCGAGTGAG-1	Fibroblasts
TTTGTTGTCGTCAGAT-1	Epithelial cells
