Barcode	cellType
AAAGGATAGGCATTTC-1	NK cells
AACACACAGGTTGTTC-1	Fibroblasts
AACCACAAGCCTAACT-1	Epithelial cells
AACCATGAGCAACCAG-1	NK cells
AACCCAAAGAGCCGAT-1	NK cells
AAGCGAGGTAGACAAT-1	Epithelial cells
AAGCGTTAGGTCATTC-1	Epithelial cells
AAGGAATCATTGCTTT-1	Fibroblasts
AAGTGAAAGTCCGTCG-1	T cells
AATCACGCAGGGACTA-1	Fibroblasts
AATGAAGCAGTTGTTG-1	Epithelial cells
AATGGAATCCACGTGG-1	Epithelial cells
ACACAGTGTTGTCCCT-1	Fibroblasts
ACAGGGACACCGTGCA-1	T cells
ACATGCATCCATCCGT-1	NK cells
ACATTTCCACGATAGG-1	NK cells
ACCACAATCTTGGCTC-1	NK cells
ACCCTCACATCCCGTT-1	Epithelial cells
ACCGTTCCAATCCTAG-1	T cells
ACGATCATCATTCGTT-1	NK cells
ACGATGTCATACCACA-1	Endothelial cells
ACGCACGTCTATTCGT-1	T cells
ACTATCTAGCGTTAGG-1	Epithelial cells
ACTATTCGTGATGAAT-1	Epithelial cells
ACTCCCAAGCACGTCC-1	T cells
ACTGCAATCTTTGCGC-1	Endothelial cells
ACTGTCCAGGAGTATT-1	Epithelial cells
ACTTAGGTCTTTCTAG-1	Epithelial cells
ACTTCGCGTAGGGAGG-1	T cells
ACTTTGTCACTCTCGT-1	NK cells
AGACAAATCTACAGGT-1	Epithelial cells
AGACACTAGTCTCGTA-1	Macrophages
AGACCCGTCCGTAATG-1	Macrophages
AGAGCAGGTGAATAAC-1	NK cells
AGAGCCCCACCAATTG-1	NK cells
AGCATCATCCGATTAG-1	Plasma cells
AGCGATTAGGTATCTC-1	NK cells
AGCGTATTCTCATTTG-1	T cells
AGCGTCGGTACGACAG-1	Epithelial cells
AGCTCAAGTTCAAGGG-1	T cells
AGGCCACGTGAATGTA-1	Plasma cells
AGGCTGCGTCTACGTA-1	Macrophages
AGTAACCCAGCGGTTC-1	NK cells
AGTAGCTAGCTCTATG-1	T cells
AGTAGTCGTTTGGCTA-1	T cells
AGTCATGCAAGGCCTC-1	Plasma cells
AGTGACTAGATCGCTT-1	Macrophages
AGTGATCAGTGAATAC-1	Plasma cells
ATACCTTTCAAACCTG-1	Epithelial cells
ATAGACCAGGTTATAG-1	T cells
ATAGACCTCCGATTAG-1	T cells
ATAGGCTGTACTGGGA-1	Endothelial cells
ATCACAGCATTGTAGC-1	T cells
ATCACGACAATACGAA-1	T cells
ATCCCTGAGAGTCTGG-1	NK cells
ATCCCTGCAGTTGTCA-1	Macrophages
ATGCCTCGTGAATGAT-1	Macrophages
ATGCCTCGTTCTTGCC-1	T cells
ATGCGATAGAAGCTGC-1	Plasma cells
ATGGAGGCATACTGAC-1	Epithelial cells
ATGGATCGTCTACGTA-1	T cells
ATGGGAGAGATGTAGT-1	NK cells
ATGGTTGAGCTTAAGA-1	Epithelial cells
ATTCAGGGTGGAAATT-1	Fibroblasts
ATTCATCCAGATCATC-1	NK cells
ATTCCCGTCGTCACCT-1	T cells
ATTCGTTTCGCCTAGG-1	Epithelial cells
ATTCTTGGTAGGCTGA-1	Fibroblasts
ATTTACCAGACCAGCA-1	T cells
CAACAACAGTCCCAGC-1	Epithelial cells
CAACAGTAGGTAACTA-1	T cells
CAACCAAAGAGGTCGT-1	NK cells
CAACGATTCGAGAGAC-1	Plasma cells
CAAGCTAAGTTTGCTG-1	T cells
CAATGACAGAAGAGCA-1	NK cells
CACTGAAAGCACGTCC-1	NK cells
CAGAGCCGTGCGTCGT-1	Macrophages
CAGATACGTCCTGAAT-1	Epithelial cells
CATACTTCATAGGAGC-1	NK cells
CATAGACAGCTATCCA-1	NK cells
CATAGACTCATCACTT-1	Fibroblasts
CATCCCAAGGCGACAT-1	Endothelial cells
CATCCGTGTATCACCA-1	T cells
CATCCGTGTCAATCTG-1	NK cells
CATGAGTTCCCGGTAG-1	Epithelial cells
CATTCATCATGGCCCA-1	NK cells
CATTCATGTTACGATC-1	Macrophages
CATTCCGCAGCGTATT-1	Epithelial cells
CATTGCCGTCATTGCA-1	Endothelial cells
CATTGCCTCCACACAA-1	Epithelial cells
CATTGTTTCATTCATC-1	NK cells
CATTGTTTCGACCATA-1	T cells
CCAAGCGCAGCGACCT-1	T cells
CCACAAATCGGTGTTA-1	Plasma cells
CCACGAGTCTTCGGAA-1	T cells
CCACGTTCAGCGTATT-1	T cells
CCACTTGTCCACATAG-1	Epithelial cells
CCCATTGCAGCTGAAG-1	Plasma cells
CCCGAAGCACAAAGCG-1	NK cells
CCGGGTAGTATGCGTT-1	Macrophages
CCGGGTATCCGTGTCT-1	NK cells
CCGGTGAAGAACTTCC-1	NK cells
CCGGTGAAGTAATCCC-1	Epithelial cells
CCTCAACTCCACAGGC-1	NK cells
CCTGCATAGCCTCACG-1	Epithelial cells
CCTTTGGAGGTTCAGG-1	Fibroblasts
CGAAGGAAGGTAGGCT-1	NK cells
CGATCGGCATCCAACA-1	NK cells
CGCAGGTAGTGCAGGT-1	Macrophages
CGCGTGAGTAGCTGCC-1	Fibroblasts
CGGAATTAGTCTTCCC-1	Fibroblasts
CGGAGAAGTCTTCCGT-1	Fibroblasts
CGGGCATTCCCATAGA-1	T cells
CGGGTGTTCTGTTCAT-1	T cells
CGTAATGTCGAAGCAG-1	Epithelial cells
CGTCAAATCGTTGTAG-1	NK cells
CGTGCTTCAGTCGTTA-1	Macrophages
CGTGCTTGTCAGGTGA-1	Epithelial cells
CGTTAGAAGTAACAGT-1	NK cells
CTAACCCTCACGAGGA-1	Epithelial cells
CTAACCCTCATCGCCT-1	NK cells
CTAACTTTCGAGGCAA-1	T cells
CTACAGATCTGCTGAA-1	Fibroblasts
CTACCTGTCCACACCT-1	Fibroblasts
CTACGGGTCATGCGGC-1	Plasma cells
CTATCCGAGGTGCTAG-1	NK cells
CTATCTAGTGGTCTGC-1	NK cells
CTCAGAACAGGGCTTC-1	T cells
CTCAGAACATCATCTT-1	Epithelial cells
CTCAGAATCCGTGGGT-1	NK cells
CTCATGCTCTTGAGCA-1	Plasma cells
CTCCATGAGGCGACAT-1	Macrophages
CTCCGATAGGCCATAG-1	Fibroblasts
CTCCTCCGTTGGAGAC-1	Fibroblasts
CTCTGGTCACCACTGG-1	NK cells
CTGATCCTCTGGACTA-1	NK cells
CTGGACGAGTGTTGTC-1	NK cells
CTGTATTCAAGGTCGA-1	Epithelial cells
CTTACCGAGCTTCGTA-1	Epithelial cells
CTTCAATCAGGTTCCG-1	Epithelial cells
CTTCCTTGTCTTACAG-1	Fibroblasts
GAACACTGTGGATCAG-1	Macrophages
GAACTGTAGCGAGTAC-1	NK cells
GACAGCCAGTTACTCG-1	Epithelial cells
GACCGTGGTCCCTGAG-1	Plasma cells
GACGCTGCAACTGCTA-1	T cells
GACTCAAAGGTGCTAG-1	NK cells
GAGATGGAGGTCATCT-1	NK cells
GAGTGAGTCCTTACCG-1	T cells
GAGTGTTCACTACCCT-1	NK cells
GAGTTGTTCTCACTCG-1	Fibroblasts
GATAGCTCAAGATGTA-1	Epithelial cells
GCAACATCATTGAAGA-1	T cells
GCACATAGTTGTTTGG-1	Macrophages
GCATCGGTCTTGTGCC-1	Epithelial cells
GCCAGCACATTGCTGA-1	T cells
GCCAGCAGTGTCCATA-1	Epithelial cells
GCCAGGTCACAGAGAC-1	Fibroblasts
GCCATTCAGCCAAGTG-1	Epithelial cells
GCCTGTTTCAAGCTTG-1	Epithelial cells
GCGAGAATCCTTCGAC-1	T cells
GCGTTTCTCCAACTAG-1	Epithelial cells
GCTACAATCCCTCTTT-1	Macrophages
GCTGGGTGTTTGCAGT-1	T cells
GCTGGGTTCTGAGATC-1	Endothelial cells
GCTTCACAGTCTCTGA-1	Epithelial cells
GGAATGGTCGTGCTCT-1	Epithelial cells
GGAGATGAGGGTCACA-1	Epithelial cells
GGAGCAACATTGCTGA-1	T cells
GGATCTACACAATGTC-1	Epithelial cells
GGATCTACATCCTTGC-1	Epithelial cells
GGGATCCGTCTCGGAC-1	Macrophages
GGGCGTTGTCGGAACA-1	Epithelial cells
GGGCTACCAACGATCT-1	Macrophages
GGGTAGAAGCATCGAG-1	NK cells
GGGTATTAGGATACGC-1	Epithelial cells
GGGTGTCAGTCAATCC-1	Epithelial cells
GGGTTTATCGTTGCCT-1	T cells
GGTAGAGCACAAGTGG-1	Epithelial cells
GGTCTGGTCTGTCAGA-1	Epithelial cells
GGTGGCTAGACATCAA-1	T cells
GGTGTCGAGAGGTTTA-1	Macrophages
GGTGTCGGTAGGCAAC-1	NK cells
GGTTCTCAGTGAGGTC-1	T cells
GGTTCTCTCCCGTAAA-1	Epithelial cells
GGTTCTCTCGTTGCCT-1	Plasma cells
GTAACACCACGGATCC-1	Fibroblasts
GTAGAGGGTGAGTAGC-1	Epithelial cells
GTAGGAGCAAGTTGGG-1	NK cells
GTAGGAGTCCGAACGC-1	Epithelial cells
GTCACTCAGACTGGGT-1	Endothelial cells
GTCATGAAGTTATGGA-1	Macrophages
GTCATGATCCGCGAGT-1	T cells
GTCCACTAGTCCCTAA-1	Macrophages
GTCCACTCAAGCTACT-1	T cells
GTCGCGACAGGAAGTC-1	Macrophages
GTGAGCCGTTCGGCGT-1	Macrophages
GTGAGCCTCACCTCTG-1	NK cells
GTGCAGCTCCACACCT-1	Epithelial cells
GTGCTTCGTGCAGGAT-1	Macrophages
GTGTTAGCAACACGAG-1	Plasma cells
GTTCTATAGGGCAATC-1	Epithelial cells
GTTGCGGTCCACCTCA-1	Plasma cells
GTTGCTCAGACAACTA-1	Epithelial cells
GTTGTAGTCCATCTGC-1	Epithelial cells
GTTTACTTCTTACCAT-1	Macrophages
GTTTGGATCAGCAATC-1	T cells
TAACTTCTCGAAGAAT-1	Epithelial cells
TAAGCACGTGTCCAAT-1	T cells
TAAGCCATCGAGTCCG-1	Fibroblasts
TACACCCAGCTGTGCC-1	NK cells
TACCCACGTGGGAGAG-1	T cells
TACCTCGCACTACCCT-1	T cells
TACCTGCCAATGCTCA-1	T cells
TACTGCCCACTCTAGA-1	NK cells
TACTTACGTCCTCCAT-1	Fibroblasts
TACTTCAAGTTGGCGA-1	Epithelial cells
TACTTGTGTCATCAGT-1	T cells
TAGACTGAGGGCAAGG-1	NK cells
TAGAGTCTCGCTCTCA-1	Plasma cells
TAGCACACACTAACGT-1	T cells
TAGGAGGAGCGTCTCG-1	Epithelial cells
TAGGAGGCACCCGTAG-1	Macrophages
TAGGAGGGTCTGATAC-1	Macrophages
TAGGGTTAGATACTGA-1	T cells
TAGTGCATCGCTAGCG-1	T cells
TATATCCCACTCCGAG-1	Epithelial cells
TATTGCTCAAACTAGA-1	Epithelial cells
TCAAGCAGTCCCGTGA-1	Endothelial cells
TCAAGTGGTCCGGACT-1	Macrophages
TCACATTCACGTACAT-1	NK cells
TCACGCTAGACCTCCG-1	T cells
TCACGGGGTACAATAG-1	NK cells
TCACGGGTCTTCGGTC-1	NK cells
TCAGTCCAGTAGTCTC-1	Fibroblasts
TCATATCGTTTGTTCT-1	T cells
TCATGCCCATGCCGCA-1	Epithelial cells
TCCATCGCAACCAGAG-1	Macrophages
TCCATGCAGCTGAGCA-1	Endothelial cells
TCCATGCCACAAAGTA-1	Macrophages
TCCATGCCATGGCCCA-1	NK cells
TCCCAGTTCTACACAG-1	T cells
TCCGATCGTCTGTGCG-1	NK cells
TCCTCCCGTTTCGTTT-1	Epithelial cells
TCCTTCTGTGGAAGTC-1	T cells
TCGGATATCGCGTGAC-1	Macrophages
TCGTAGAGTGACGCCT-1	Epithelial cells
TCTCAGCAGCCTCCAG-1	Epithelial cells
TCTGGCTTCAACGAGG-1	Epithelial cells
TCTTAGTTCAAGCTTG-1	Fibroblasts
TCTTCCTCACTTGTGA-1	T cells
TGAACGTAGAAGTCAT-1	Macrophages
TGACGCGCATTCCTCG-1	T cells
TGAGACTCAGTAGTGG-1	T cells
TGAGCATGTGAGACCA-1	NK cells
TGAGCGCCACCCTGTT-1	T cells
TGAGTCAAGACTCGAG-1	NK cells
TGAGTCAAGATGCCGA-1	Epithelial cells
TGCAGATGTCATCGCG-1	Epithelial cells
TGCAGATTCGATTGGT-1	Endothelial cells
TGCGACGCATGGGCAA-1	T cells
TGCGATACAGACCTGC-1	Endothelial cells
TGGAGGACAGCTGAAG-1	T cells
TGTAACGGTTACCTTT-1	T cells
TGTAAGCCATCCTCAC-1	Epithelial cells
TGTCAGATCAAATAGG-1	Macrophages
TGTTACTCAGCGACAA-1	Endothelial cells
TGTTCTATCGTTCAGA-1	Plasma cells
TGTTGGACACCGTGGT-1	NK cells
TTACGTTAGTACGTCT-1	Fibroblasts
TTCAGGAGTGTTTGCA-1	Endothelial cells
TTCCACGCAGGCTATT-1	Macrophages
TTCCGGTTCCGTGTGG-1	Fibroblasts
TTCCTAAGTTATCTGG-1	T cells
TTCGCTGTCTTCGTAT-1	Macrophages
TTCTCTCCACCTTCCA-1	NK cells
TTGGTTTAGGATTCCT-1	T cells
TTGTGGATCCTAAGTG-1	Epithelial cells
TTGTTGTCATTACGGT-1	Fibroblasts
TTGTTGTTCAGAACCT-1	Macrophages
TTGTTTGTCAGCTAGT-1	Epithelial cells
TTTGGTTTCCTGTTAT-1	Epithelial cells
TTTGTTGCACACCTTC-1	Fibroblasts
